綈	false	⿰糹弟
驉	false	⿰馬虚
羲	true	羲
豚	true	豚
繰	true	繰
戡	true	戡
㡼	false	⿸广曳
貲	true	貲
蠁	true	蠁
餭	false	⿰飠皇
胑	false	⿰月只
肒	false	⿰月丸
迥	true	迥
㐄	true	㐄
鱏	true	鱏
縋	false	⿰糹追
哠	false	⿰口告
栾	false	⿱亦木
熏	true	熏
鐼	true	鐼
交	true	交
福	true	福
胏	false	⿰月𠂔
麋	false	⿸鹿米
腳	false	⿰月卻
緀	false	⿰糹妻
黷	true	黷
勼	true	勼
㣺	false	㣺
鮺	false	⿸羊魚
玨	true	玨
毀	false	毀
冤	true	冤
鼠	true	鼠
腜	true	腜
梢	true	梢
侂	true	侂
縸	false	⿰糹莫
餗	true	餗
彔	true	彔
禢	false	⿰礻𦐇
俘	true	俘
欶	true	欶
鏡	true	鏡
膮	false	⿰月堯
繸	false	⿰糹遂
丷	false	丷
鋊	true	鋊
剔	true	剔
頼	false	頼
儲	true	儲
将	false	⿰丬𪧷
簆	false	⿱竹𡨥
揸	false	⿰扌查
窒	false	窒
當	true	當
需	false	需
軔	true	軔
斝	true	斝
饓	false	⿰飠⿱𫩠木
㾔	false	⿸疒吕
蕈	true	蕈
麮	true	麮
開	true	開
𧍷	true	𧍷
䍃	false	⿱⿱丿𭕄缶
冢	false	冢
朵	false	⿱几木
膁	false	⿰月兼
摳	true	摳
返	true	返
稍	true	稍
臇	false	⿰月雋
虐	false	⿸虍⿻匚一
揤	false	⿰扌即
旋	false	旋
脝	false	⿰月亨
姿	true	姿
惴	true	惴
不	true	不
鬾	true	鬾
平	true	平
脟	false	⿰月寽
綢	false	⿰糹周
徜	false	⿰彳尚
螷	false	⿱庳虫
前	true	前
莑	false	莑
界	true	界
繮	false	⿰糹畺
飯	true	飯
劍	true	劍
饀	false	⿰飠舀
䭇	false	⿰飠⿹勹吉
亦	true	亦
繘	true	繘
擢	true	擢
摌	false	⿰扌産
聖	false	⿱𦔻王
肸	false	⿰月⿱八十
尢	true	尢
隉	false	⿰阝𬛸
飩	false	⿰飠屯
奚	false	奚
䤑	false	⿰酉黄
使	true	使
犯	true	犯
甌	true	甌
薔	true	薔
透	true	透
耳	true	耳
突	true	突
燿	true	燿
黭	true	黭
繕	true	繕
舂	true	舂
匣	true	匣
憝	true	憝
腟	false	⿰月室
緹	false	⿰糹是
隶	true	隶
倦	true	倦
灋	true	灋
䐹	false	⿰月肅
兌	true	兌
犁	true	犁
則	true	則
嘗	true	嘗
咆	true	咆
倏	true	倏
彭	false	彭
疵	true	疵
鐕	true	鐕
肥	false	⿰月巴
俜	true	俜
絻	false	⿰糹⿱𠂊⑤
仰	true	仰
擅	true	擅
墉	true	墉
錮	true	錮
倌	true	倌
嚮	false	⿱鄉向
寧	true	寧
妁	true	妁
鱑	false	⿰魚黄
莔	true	莔
楝	true	楝
歌	true	歌
端	true	端
僤	true	僤
䢻	true	䢻
捲	false	⿰扌⿱龹㔾
腣	false	⿰月帝
覘	true	覘
臀	false	⿱殿月
雙	true	雙
檕	false	⿱𣪠木
褌	true	褌
啚	true	啚
決	true	決
龹	false	龹
犝	true	犝
商	true	商
脇	false	⿰月劦
麼	false	麼
綰	false	⿰糹官
蔑	false	⿱𦭝戍
緝	false	⿰糹咠
蝕	false	⿰飠虫
肖	true	肖
吪	true	吪
蚼	true	蚼
胣	false	⿰月㐌
漚	true	漚
𦥯	false	𦥯
堬	false	⿰土俞
㔸	false	⿷匚虒
皇	false	皇
紩	false	⿰糹失
塚	false	⿰土冢
身	true	身
忠	true	忠
䭞	false	⿰飠睪
䵤	false	⿱开黑
胹	false	⿰月而
聿	true	聿
活	true	活
星	false	星
造	false	⿺辶告
罿	true	罿
筍	true	筍
銴	true	銴
轈	true	轈
緡	false	⿰糹昬
胼	false	⿰月并
槱	false	⿰木⿱酉灬
爨	false	⿱⿶⿱𦥑冖同𤍾
虎	true	虎
𠤏	true	𠤏
綹	false	⿰糹咎
慒	true	慒
誠	true	誠
染	true	染
鷲	true	鷲
黝	true	黝
紶	false	⿰糹去
倀	true	倀
䐫	false	⿰月從
冉	true	冉
鈂	true	鈂
㳫	false	⿱水臼
涶	true	涶
若	true	若
𣬉	false	𣬉
莒	false	⿱⿻十丨吕
咺	true	咺
帝	true	帝
柷	true	柷
禅	false	⿰礻单
丶	true	丶
膋	false	⿱𤇾月
阝	false	阝
乍	true	乍
謽	false	⿱强言
彰	true	彰
煔	true	煔
衲	false	⿰衤内
䟜	false	⿰𧾷内
麕	false	⿸鹿囷
更	true	更
股	true	股
徽	false	⿰彳𢾰
蠹	true	蠹
繐	false	⿰糹惠
縹	false	⿰糹票
羠	true	羠
萠	false	⿱⿻十丨朋
豔	true	豔
脴	false	⿰月否
央	true	央
叫	true	叫
從	true	從
盥	true	盥
月	true	月
淊	true	淊
點	true	點
尋	true	尋
微	false	⿰彳𢼸
昆	false	昆
亙	true	亙
腪	false	⿰月軍
㐁	true	㐁
单	false	单
繶	false	⿰糹意
桀	false	⿱舛木
昁	false	⿰日巿
綞	false	⿰糹垂
夢	false	⿳𦭝冖夕
膼	false	⿰月過
禰	false	⿰礻爾
叱	true	叱
懁	true	懁
退	true	退
廡	true	廡
𭕄	false	𭕄
禚	false	⿰礻羔
咦	true	咦
楽	false	⿱⿴⿱丷八白木
絝	false	⿰糹夸
首	true	首
卑	true	卑
紆	false	⿰糹于
䐻	false	⿰月辜
紣	false	⿰糹卆
衆	false	衆
叢	true	叢
紿	false	⿰糹台
匚	true	匚
丏	true	丏
既	false	既
洟	true	洟
丈	true	丈
刅	true	刅
儔	true	儔
查	false	查
餝	false	⿰飠芳
跎	true	跎
寪	false	⿱宀爲
禴	false	⿰礻龠
惠	false	惠
雬	false	⿱雨木
弓	true	弓
半	false	⿱丷⿻二丨
蹎	false	⿰𧾷真
嗼	true	嗼
鞗	false	⿰⿰亻丨⿱夂革
升	true	升
萄	true	萄
浅	false	⿰氵戋
率	false	率
四	true	四
皾	false	⿰賣皮
闓	true	闓
措	true	措
䏕	false	⿰月壬
死	true	死
乡	false	乡
沈	true	沈
雎	true	雎
娧	false	⿰女兑
鼫	true	鼫
毚	false	毚
䔼	false	⿱⿻十丨歰
周	true	周
忘	true	忘
㐱	true	㐱
曼	false	⿳日罒又
瀞	false	⿰氵静
鷮	true	鷮
姁	true	姁
繨	false	⿰糹達
糾	true	糾
𡉀	false	𡉀
纈	false	⿰糹頡
侐	true	侐
从	true	从
迎	true	迎
腈	false	⿰月青
䍪	false	⿰羊未
良	true	良
褗	true	褗
霝	true	霝
脮	false	⿰月妥
黶	true	黶
鞴	false	⿰革𤰇
餅	false	⿰飠并
只	false	只
豩	true	豩
扈	false	⿸户邑
蹠	false	⿰𧾷庶
狝	false	⿰犭尔
駼	true	駼
皓	false	⿰白告
陶	true	陶
襮	true	襮
沾	true	沾
䏱	false	⿰月局
鴌	false	⿱天鳥
㲺	false	⿰氵七
左	true	左
己	true	己
崙	true	崙
垂	true	垂
䈿	false	⿱竹冥
㺄	false	⿰犭俞
奓	false	奓
縐	true	縐
䏜	false	⿰月及
庉	true	庉
却	false	却
匴	true	匴
水	true	水
熜	false	⿰火悤
窗	false	⿱穴⿴⿱丿囗夂
胗	false	⿰月㐱
履	true	履
境	true	境
繚	false	⿰糹尞
釘	true	釘
鬄	true	鬄
雝	true	雝
餄	false	⿰飠合
臘	false	⿰月巤
潧	true	潧
埾	true	埾
歂	true	歂
諂	true	諂
膈	false	⿰月鬲
醫	true	醫
㞢	false	㞢
幧	true	幧
寅	false	寅
橦	true	橦
詐	true	詐
訂	true	訂
匭	true	匭
鄚	true	鄚
原	true	原
𥑟	false	𥑟
少	false	少
氈	true	氈
榗	false	⿰木晋
壄	false	⿱楙土
箐	false	⿱竹青
皀	true	皀
昱	true	昱
粒	true	粒
昔	true	昔
島	true	島
有	true	有
倩	true	倩
义	false	义
餡	false	⿰飠臽
纞	false	⿰糹戀
鄬	false	⿰爲阝
寮	true	寮
竭	true	竭
䐗	false	⿰月者
㸬	false	⿰牛巿
饜	false	⿸厭食
紖	false	⿰糹引
㦃	false	⿰忄産
餚	false	⿰飠⿱㐅有
錆	false	⿰金青
侚	true	侚
葬	true	葬
賞	true	賞
抣	false	⿰扌匀
廷	false	⿺廴壬
淌	false	⿰氵尚
䬦	false	⿰飠殳
揄	false	⿰扌俞
叟	false	⿱⿻臼丨又
䃾	true	䃾
郇	true	郇
襩	true	襩
龜	true	龜
詥	true	詥
粛	false	粛
麷	false	⿰麥豐
毃	true	毃
余	true	余
諭	false	⿰言俞
㕯	false	⿵内口
厲	true	厲
櫝	true	櫝
厂	true	厂
呰	true	呰
慈	false	慈
屮	true	屮
麚	true	麚
黌	false	⿱𦥯黄
香	true	香
邉	false	⿺辶⿳自穴口
祋	true	祋
羶	true	羶
痜	false	⿸疒秃
䢴	false	⿰干阝
僵	true	僵
纖	false	⿰糹韱
筋	true	筋
捶	true	捶
哨	true	哨
纊	false	⿰糹廣
塾	true	塾
隻	false	隻
别	false	别
絥	false	⿰糹伏
翠	true	翠
象	true	象
茄	true	茄
祕	false	⿰礻必
繍	false	⿰糹粛
胻	false	⿰月行
髢	true	髢
瀾	true	瀾
朏	true	朏
色	true	色
麰	false	⿰麥牟
臂	false	⿱辟月
饂	false	⿰飠昷
紈	false	⿰糹丸
肣	true	肣
𠔼	true	𠔼
爭	true	爭
膡	false	⿰月⿱龹目
橫	true	橫
蠆	true	蠆
饗	true	饗
肅	false	肅
覃	true	覃
斜	true	斜
雊	true	雊
幠	true	幠
廴	true	廴
嫫	true	嫫
縔	false	⿰糹桑
槳	false	⿱將木
没	false	没
豕	true	豕
笭	true	笭
販	true	販
龵	false	龵
緺	false	⿰糹咼
囍	false	⿰喜喜
豹	true	豹
緆	true	緆
鼤	false	⿰鼠文
胲	false	⿰月亥
膿	false	⿰月農
臒	false	⿰月⿱⿻十丨隻
纁	false	⿰糹熏
朩	false	朩
集	false	⿱隹木
熊	true	熊
㼢	false	⿰𦣞瓦
琢	false	⿰王豖
芍	true	芍
䋍	false	⿰糹可
耕	true	耕
阻	true	阻
乳	true	乳
花	true	花
蛇	true	蛇
狾	true	狾
傆	true	傆
化	true	化
順	true	順
衁	true	衁
懲	false	⿱徵心
祗	false	⿰礻⿱氏丶
焱	false	焱
枼	false	⿱世木
䇷	false	⿱竹别
粦	true	粦
猜	true	猜
脉	false	⿰月永
薄	false	⿱⿻十丨溥
穴	true	穴
胈	false	⿰月⿺友丶
形	true	形
㹤	true	㹤
䂱	false	⿰石兑
憤	true	憤
胵	false	⿰月至
蛤	true	蛤
瘝	false	⿸疒⿱罒⑤
亶	true	亶
剱	false	⿰㑒刃
挋	true	挋
聕	false	⿰耳告
虯	true	虯
粤	false	⿱⿴⿱丿囗米丂
虹	true	虹
蹴	true	蹴
妌	true	妌
鍾	true	鍾
䍙	false	⿱罒每
餑	false	⿰飠孛
歹	true	歹
緯	false	⿰糹韋
胘	false	⿰月玄
殂	true	殂
奪	true	奪
傎	false	⿰亻真
呁	false	⿰口匀
酌	true	酌
繝	false	⿰糹閒
螭	true	螭
行	true	行
軋	true	軋
縊	false	⿰糹⿱⿱䒑八皿
脅	true	脅
傔	true	傔
闌	true	闌
腹	true	腹
𠤎	true	𠤎
飭	false	⿰飠⿱𠂉力
鬊	true	鬊
灼	true	灼
毛	true	毛
餰	false	⿰飠衍
痀	true	痀
竟	true	竟
䂒	false	⿰矢𠮷
腎	false	⿱臤月
久	true	久
册	false	册
祭	true	祭
幟	true	幟
黵	true	黵
鄣	true	鄣
繦	false	⿰糹强
瞻	true	瞻
觠	false	⿱龹角
䑍	false	⿰月嬰
毺	false	⿺毛俞
腵	false	⿰月叚
訹	false	⿰言术
約	true	約
偕	true	偕
絢	true	絢
夬	true	夬
业	false	业
投	true	投
黳	true	黳
勸	true	勸
穀	false	⿰𥞤殳
傷	true	傷
悴	true	悴
匼	false	⿷匚合
嵼	false	⿰山産
綝	false	⿰糹林
蜼	true	蜼
瓽	true	瓽
㖨	false	⿰口录
彣	true	彣
㡏	false	⿰巾俞
親	true	親
蕝	false	⿱⿻十丨⿰糹色
緗	false	⿰糹相
山	true	山
陲	true	陲
農	true	農
柺	false	⿰木另
鴗	true	鴗
䞈	false	⿰貝爲
骪	false	⿰骨凡
霩	true	霩
五	true	五
硞	false	⿰石告
䖺	false	⿰⿰亻丨𧈸
緛	false	⿰糹耎
惝	false	⿰忄尚
潏	true	潏
鑟	false	⿰金賣
抐	false	⿰扌内
堲	false	⿱即土
麳	false	⿰麥來
崛	true	崛
虁	false	⿱⿻十丨夔
貓	true	貓
瓦	true	瓦
㪁	false	⿰今攴
顫	true	顫
賸	false	⿰月⿱龹貝
僭	true	僭
䙲	true	䙲
黮	true	黮
兩	true	兩
纕	false	⿰糹襄
肑	true	肑
闇	true	闇
脫	false	⿰月兌
郢	false	⿰⿱口王阝
琅	true	琅
鮎	true	鮎
脯	false	⿰月甫
卞	false	卞
⺸	false	⺸
賓	false	⿱⿱宀⿱一𣥂貝
設	true	設
菡	true	菡
訇	true	訇
㪢	false	⿰⿱⿻臼丨又攴
饘	true	饘
犙	true	犙
幵	true	幵
巢	true	巢
璐	true	璐
戒	true	戒
貤	true	貤
胖	true	胖
本	true	本
飠	false	飠
桃	true	桃
賢	true	賢
𧾷	false	𧾷
亅	true	亅
趨	true	趨
紬	false	⿰糹由
汎	true	汎
窴	false	⿱穴真
旗	true	旗
扮	true	扮
縡	false	⿰糹宰
麝	false	⿸鹿射
犬	true	犬
篆	true	篆
男	true	男
棋	true	棋
臕	false	⿰月麃
窖	false	⿱穴告
澚	false	⿰氵⿱⿵⿱丿冂米丂
答	false	答
殫	true	殫
䢭	false	⿺辶羡
卉	true	卉
𡱁	false	𡱁
胊	false	⿰月句
棦	false	⿰木爭
僎	true	僎
冖	true	冖
腿	false	⿰月退
䐚	false	⿰月即
帟	true	帟
妥	false	妥
獻	true	獻
丣	true	丣
戀	false	戀
純	true	純
縯	false	⿰糹寅
阪	true	阪
国	false	国
朱	false	朱
縺	false	⿰糹連
亭	true	亭
彘	true	彘
者	true	者
䴰	false	⿰麥戈
繳	false	⿰糹敫
𤟍	true	𤟍
揍	false	⿰扌奏
檢	true	檢
䐵	false	⿰月黄
䝧	false	⿰貝匀
疽	true	疽
粣	false	⿰米册
㯆	false	⿰木産
識	true	識
恤	true	恤
總	true	總
魄	true	魄
脠	false	⿰月⿺廴⿱丿③
邁	true	邁
寡	true	寡
頂	true	頂
捎	true	捎
禔	false	⿰礻是
莭	false	⿱⿻十丨即
幼	true	幼
肴	false	⿱㐅有
俑	true	俑
玲	true	玲
囂	true	囂
螣	true	螣
崩	false	崩
夾	true	夾
餃	false	⿰飠交
膧	false	⿰月童
𠫓	false	𠫓
趜	true	趜
編	false	⿰糹⿸户𠕁
緤	false	⿰糹⿱世木
遄	true	遄
㔴	true	㔴
修	true	修
佩	true	佩
鼽	true	鼽
黜	true	黜
㔾	false	㔾
戺	false	⿰户巳
俎	true	俎
顥	true	顥
柞	true	柞
卜	true	卜
崒	true	崒
卹	true	卹
鮵	false	⿰魚兑
炢	false	⿰火术
勃	true	勃
饌	false	⿰飠⿱⿰巳巳共
彐	true	彐
漠	true	漠
歾	true	歾
乑	false	乑
銷	true	銷
抑	true	抑
窣	true	窣
粶	false	⿰米录
兓	false	⿰旡旡
球	true	球
檐	true	檐
泂	true	泂
囮	true	囮
麌	false	⿸鹿吴
矩	false	矩
晃	true	晃
孔	true	孔
栞	false	⿱幵木
辛	true	辛
褞	false	⿰衤昷
隹	true	隹
朚	true	朚
繽	false	⿰糹⿱⿱宀⿱一𣥂貝
偫	true	偫
古	true	古
蟺	true	蟺
䑁	false	⿱𦥯月
硠	true	硠
法	true	法
痍	true	痍
丨	true	丨
䏚	false	⿰月少
匍	true	匍
羸	true	羸
峀	false	⿱山由
𭯺	false	𭯺
寬	false	⿱宀萈
睪	false	睪
魲	false	⿰魚户
蔇	false	⿱⿻十丨既
粢	true	粢
臊	true	臊
鶬	true	鶬
禭	false	⿰礻遂
䵌	false	⿰黄夾
卮	true	卮
洖	false	⿰氵吴
斀	true	斀
監	false	⿱⿰臣⿱𠂉丶皿
仍	true	仍
運	true	運
䴯	false	⿰麥勿
櫫	false	⿱豬木
彦	false	彦
醉	true	醉
惹	true	惹
岳	true	岳
浴	true	浴
𠔉	false	𠔉
枝	true	枝
覉	false	⿱覀䩭
米	true	米
宛	false	宛
罒	false	罒
李	true	李
辵	true	辵
䬝	false	⿺風黄
䜜	false	⿰言睿
捨	false	⿰扌舍
泳	true	泳
勂	false	⿰告力
鳳	true	鳳
彥	true	彥
灵	false	⿱彐火
曏	true	曏
抯	true	抯
依	true	依
鴡	true	鴡
䨿	false	䨿
勳	false	勳
羯	true	羯
簅	false	⿱竹産
仡	true	仡
纗	false	⿰糹巂
驚	true	驚
箪	false	⿱竹单
膳	true	膳
颭	true	颭
讟	true	讟
丢	false	丢
絲	false	⿰糹糸
莽	false	⿱𦬫廾
酊	true	酊
胾	true	胾
閒	false	閒
歕	true	歕
見	true	見
箬	true	箬
陬	true	陬
傞	true	傞
胅	false	⿰月失
錘	true	錘
㔷	true	㔷
嫄	true	嫄
鼰	false	⿰鼠貝
臤	true	臤
鷺	true	鷺
檗	false	⿱辟木
鐭	false	⿰金奥
珈	true	珈
毹	false	⿰俞毛
厷	false	厷
肍	false	⿰月九
齴	false	⿰齒彦
餲	true	餲
蛉	true	蛉
早	true	早
咊	true	咊
潼	true	潼
韵	false	⿰音匀
文	true	文
𠄔	true	𠄔
腱	false	⿰月建
㰘	false	⿰木彝
晴	false	⿰日青
定	false	定
遀	false	遀
称	false	⿰禾尔
家	true	家
猶	true	猶
甲	true	甲
鯽	false	⿰魚即
䏛	false	⿰月勻
弇	true	弇
河	true	河
誤	false	⿰言吴
啄	false	⿰口豖
姶	true	姶
噴	true	噴
薦	true	薦
脄	false	⿰月灰
倚	true	倚
澡	true	澡
瓪	true	瓪
鹵	true	鹵
齜	true	齜
䂞	false	⿱石木
尃	false	尃
縗	false	⿰糹衰
篾	false	⿳竹罒戍
轉	true	轉
田	true	田
𢼸	false	𢼸
礇	false	⿰石奥
鼲	true	鼲
石	true	石
杲	false	⿱日木
帣	false	⿱龹巾
裒	false	⿳亠臼𧘇
迮	true	迮
佞	true	佞
休	true	休
禍	true	禍
匕	true	匕
䐒	false	⿰月奓
繾	false	⿰糹遣
㪈	false	⿰圭攴
㔳	true	㔳
繙	false	⿰糹番
吹	true	吹
㫃	true	㫃
朁	true	朁
奇	false	奇
佳	true	佳
笵	true	笵
孼	false	⿱辥子
鞠	true	鞠
繊	false	⿰糹⿹𢦏业
鱣	true	鱣
枃	false	⿰木匀
繈	false	⿰糹強
吝	true	吝
䐝	false	⿰月𧴪
罔	true	罔
咷	true	咷
鎡	false	⿰金兹
烜	true	烜
㕚	true	㕚
豸	true	豸
䋨	false	⿰糹咅
餕	false	⿰飠⿳厶八夂
匪	true	匪
能	true	能
祠	false	⿰礻司
簪	true	簪
矢	true	矢
緬	false	⿰糹面
紙	true	紙
桑	true	桑
汘	true	汘
嶨	true	嶨
搿	false	⿲龵合手
奥	false	奥
陸	true	陸
䫀	true	䫀
荅	true	荅
虩	false	⿰𡭴虎
尹	true	尹
謳	true	謳
熬	true	熬
國	true	國
儹	true	儹
莧	true	莧
嗑	true	嗑
踭	false	⿰𧾷争
䐊	false	⿰月昆
覂	false	⿱覀乏
紳	false	⿰糹申
偲	true	偲
局	true	局
僄	true	僄
麿	false	⿸麻吕
竇	true	竇
膲	false	⿰月焦
䘤	false	⿰衤术
䭝	false	⿰飠會
启	false	⿸户口
淇	true	淇
髟	true	髟
槀	false	⿱高木
䯜	true	䯜
䱚	false	⿰魚录
縒	false	⿰糹差
瑞	true	瑞
璚	true	璚
門	true	門
扟	true	扟
妒	false	⿰女户
帀	false	帀
匋	true	匋
蔿	false	蔿
右	true	右
③	false	③
分	true	分
一	true	一
望	false	⿱⿰亡月王
村	true	村
喗	true	喗
嬯	true	嬯
宦	true	宦
䏘	false	⿰月匹
畾	false	畾
春	true	春
喜	false	喜
胿	false	⿰月圭
䩭	false	䩭
秫	true	秫
馗	true	馗
甿	true	甿
彑	true	彑
吾	true	吾
弚	false	⿱丷弔
愿	true	愿
脢	false	⿰月每
番	false	番
諅	true	諅
飥	false	⿰飠乇
凔	true	凔
召	true	召
逝	true	逝
䐲	false	⿰月習
擳	false	⿰扌⿱竹即
繃	false	⿰糹崩
絚	false	⿰糹亙
腁	false	⿰月幷
𤰔	false	𤰔
綷	false	⿰糹卒
硩	true	硩
䢱	false	⿺辶賣
撝	false	⿰扌爲
捁	false	⿰扌告
巷	false	⿱共巳
誶	true	誶
静	false	静
緇	false	⿰糹甾
泡	true	泡
儷	true	儷
頡	false	頡
㽧	false	⿰田兹
近	true	近
辟	false	辟
脘	false	⿰月完
恣	true	恣
鏟	false	⿰金産
緕	false	⿰糹斉
亏	false	亏
𮅕	false	𮅕
佺	true	佺
酋	false	⿱丷酉
歎	false	⿰⿱廿⿻口夫欠
臝	false	⿱吂⿲月果凡
銀	true	銀
禷	false	⿰礻⿰类頁
酢	true	酢
廌	true	廌
間	true	間
絜	false	絜
壓	false	⿱厭土
贊	false	贊
犡	true	犡
城	true	城
俱	true	俱
宜	true	宜
肩	true	肩
朶	false	⿱乃木
旨	true	旨
枷	true	枷
箸	true	箸
絞	false	⿰糹交
拓	true	拓
侍	true	侍
楨	true	楨
它	true	它
禘	false	⿰礻帝
縳	false	⿰糹專
䏪	false	⿰月耳
䏰	false	⿰月忍
宮	true	宮
𠂤	true	𠂤
栗	false	⿱覀木
麒	true	麒
各	true	各
鼉	true	鼉
譖	true	譖
衠	false	⿲彳真亍
匬	true	匬
樹	true	樹
麬	false	⿰麥皮
爂	false	⿱⿶⿱𦥑冖同火
之	true	之
紪	false	⿰糹此
輻	true	輻
疃	true	疃
保	true	保
𧰨	false	𧰨
腆	false	⿰月典
祊	false	⿰礻方
筥	false	⿱竹吕
基	true	基
累	false	累
䴾	false	⿰麥差
臁	false	⿰月廉
疫	true	疫
禯	false	⿰礻農
梠	false	⿰木吕
黥	true	黥
姕	true	姕
頜	true	頜
繥	false	⿰糹喜
韋	true	韋
禫	true	禫
神	true	神
璅	true	璅
鮑	true	鮑
馽	true	馽
卼	false	⿺兀危
袉	true	袉
瑕	true	瑕
緪	false	⿰糹恆
㒼	false	㒼
兀	true	兀
贖	true	贖
表	false	表
饡	false	⿰飠贊
𠂔	false	𠂔
艮	true	艮
嫗	true	嫗
匫	true	匫
黚	true	黚
㯻	false	⿱⿳⿻一中冖豕木
牧	true	牧
綅	false	⿰糹𠬶
經	false	⿰糹巠
俊	true	俊
縤	false	⿰糹素
算	true	算
軜	false	⿰車内
䄝	false	⿰礻舂
敫	false	敫
箓	false	⿱竹录
鄲	true	鄲
魼	true	魼
暈	true	暈
脚	false	⿰月却
捛	false	⿰扌吕
鐘	true	鐘
䬣	false	⿰飠乞
䌈	false	⿰糹𦐇
鄃	false	⿰俞阝
食	true	食
敗	true	敗
𣎆	true	𣎆
蟬	true	蟬
海	true	海
傅	true	傅
齳	true	齳
鋵	false	⿰金秃
絈	false	⿰糹白
綋	false	⿰糹宏
磌	false	⿰石真
涿	true	涿
䕲	false	⿱⿻十丨廩
睗	true	睗
跖	true	跖
束	true	束
璵	true	璵
綳	false	⿰糹朋
桹	true	桹
兪	false	⿱亼⿰月巜
纘	false	⿰糹贊
音	true	音
弥	false	⿰弓尔
宗	true	宗
紾	false	⿰糹㐱
鈩	false	⿰金户
餞	false	⿰飠戔
趮	true	趮
脕	false	⿰月⿱𠂊⑤
㜗	true	㜗
畻	false	⿰田⿱龹土
飶	false	⿰飠必
矛	true	矛
謷	true	謷
緫	false	⿰糹怱
縕	false	⿰糹𥁕
血	true	血
遥	false	⿺辶⿱⿱丿𭕄缶
諫	true	諫
勹	true	勹
䐳	false	⿰月魚
禾	true	禾
雲	true	雲
緦	false	⿰糹思
摹	true	摹
君	true	君
伺	true	伺
颮	true	颮
窞	true	窞
唇	false	⿸辰口
抱	true	抱
畢	false	畢
草	true	草
德	true	德
亼	true	亼
肨	false	⿰月丰
䃗	false	⿰石剥
簿	false	⿱竹溥
滻	false	⿰氵産
佛	true	佛
宏	true	宏
帨	false	⿰巾兑
緃	false	⿰糹⿱从龰
膞	false	⿰月專
肶	false	⿰月比
鮡	true	鮡
諆	true	諆
勇	false	⿱甬力
䕝	false	⿱⿻十丨稱
祔	false	⿰礻付
酬	true	酬
感	true	感
䐣	false	⿰月員
涼	true	涼
祑	false	⿰礻失
縚	false	⿰糹舀
啙	true	啙
赮	true	赮
胰	false	⿰月夷
澘	false	⿰氵𣈅
彛	false	⿱彐𪪷
𦧇	true	𦧇
內	true	內
金	true	金
蝠	true	蝠
鸒	true	鸒
腦	false	⿰月𡿺
藋	true	藋
繅	true	繅
昈	false	⿰日户
敻	true	敻
襜	true	襜
媒	true	媒
𦍌	false	𦍌
瑵	true	瑵
盧	false	盧
肺	false	⿰月巿
敹	false	⿰𥹄攵
萑	false	萑
欨	true	欨
青	true	青
丮	true	丮
末	false	末
綆	false	⿰糹更
虜	false	⿸虍男
橜	false	⿱厥木
憺	true	憺
氓	true	氓
憯	true	憯
肳	false	⿰月勿
蔃	false	⿱⿻十丨强
暉	true	暉
甗	true	甗
坈	false	⿰土冗
疊	false	疊
黋	false	⿺光黄
饇	false	⿰飠區
綠	true	綠
濁	true	濁
縧	false	⿰糹⿰⿰亻丨⿱夂朩
肜	false	⿰月彡
瞢	false	⿳𦭝冖目
絣	false	⿰糹并
藻	true	藻
訦	true	訦
路	true	路
競	true	競
䄲	false	⿰禾内
敡	true	敡
鳦	true	鳦
冡	true	冡
呂	false	呂
氅	true	氅
痂	true	痂
𢓊	true	𢓊
愒	true	愒
朢	false	⿱⿰臣月王
牣	true	牣
啻	false	啻
扨	false	⿰扌刃
囗	true	囗
宁	true	宁
揣	true	揣
𠴫	true	𠴫
綀	true	綀
欴	false	⿰⿱丶⑤欠
朔	false	朔
𥁕	false	𥁕
蘉	false	⿳𦭝冖侵
儥	true	儥
茝	false	⿱⿻十丨𦣞
誥	true	誥
膬	false	⿰月毳
岑	true	岑
閃	false	閃
帰	false	⿰②帚
䐜	false	⿰月真
蝮	true	蝮
唐	false	⿸广⿱肀口
旐	true	旐
紫	true	紫
曾	true	曾
䴈	false	⿰奧鳥
䐺	false	⿰月覃
槃	false	⿱般木
繡	false	⿰糹肅
蝍	false	⿰虫即
鷀	false	⿰兹鳥
龍	true	龍
飫	false	⿰飠夭
鄗	true	鄗
餉	false	⿰飠向
蔡	true	蔡
頃	true	頃
徦	true	徦
勿	true	勿
輂	true	輂
忄	false	忄
琹	false	⿱玨木
𢻫	true	𢻫
僻	true	僻
䏐	false	⿰月夬
岵	true	岵
堨	true	堨
逸	false	⿺辶兔
医	true	医
停	true	停
占	true	占
僉	true	僉
凞	false	⿰冫熈
恂	true	恂
酤	true	酤
繹	false	⿰糹睪
墨	false	⿱黑土
泉	true	泉
騋	true	騋
鶹	false	⿰留鳥
井	true	井
飛	true	飛
覆	true	覆
覿	true	覿
懥	false	⿰忄疐
敞	true	敞
踧	true	踧
倍	true	倍
臐	false	⿰月熏
鼯	false	⿰鼠吾
麦	false	麦
彗	false	⿱⿰丰丰彐
廾	true	廾
复	true	复
傀	true	傀
閭	false	⿵門吕
糟	true	糟
鬑	true	鬑
肧	false	⿰月不
㔃	false	⿱⿰糹色刀
鼳	false	⿰鼠狊
涑	true	涑
縵	false	⿰糹⿳日罒又
颸	true	颸
礡	false	⿰石蒪
曲	true	曲
䚻	true	䚻
稱	true	稱
羽	true	羽
辜	true	辜
偭	true	偭
咅	false	咅
蒝	true	蒝
祱	false	⿰礻兑
㓳	false	⿺是刂
𢀖	false	𢀖
祝	true	祝
綽	false	⿰糹卓
瑯	false	⿰王郎
胍	false	⿰月瓜
敺	true	敺
裳	true	裳
𠬢	true	𠬢
櫜	true	櫜
臧	true	臧
鄉	true	鄉
究	true	究
脰	false	⿰月豆
㫽	false	⿰日录
翟	true	翟
顄	true	顄
參	true	參
位	true	位
餟	false	⿰飠叕
㢟	false	⿺廴③
瀛	true	瀛
詖	true	詖
聯	true	聯
褼	false	⿰衤⿱䙲巳
齊	true	齊
䐙	false	⿰月革
匊	true	匊
吳	true	吳
取	true	取
餧	false	⿰飠委
䏏	false	⿰月于
鏹	false	⿰金强
玄	true	玄
艼	true	艼
䏼	false	⿰月戔
誓	true	誓
鏌	true	鏌
犓	true	犓
煉	true	煉
纚	false	⿰糹麗
𡬠	false	𡬠
覅	false	⿰要勿
莫	true	莫
葍	true	葍
刀	true	刀
㫟	false	⿰日⿱𠘧口
䑀	false	⿰月辟
脱	false	⿰月兑
㫦	false	⿰⿰亻丨𣅈
裻	true	裻
鼷	false	⿰鼠奚
邯	true	邯
䝦	false	⿰豸衆
趢	false	⿺走录
段	false	段
鰦	false	⿰魚兹
綌	true	綌
僖	true	僖
紼	false	⿰糹弗
䟣	false	⿰𧾷术
綸	false	⿰糹侖
塏	true	塏
揮	true	揮
泣	true	泣
縉	false	⿰糹晋
澶	true	澶
胢	false	⿰月可
奮	true	奮
喭	false	⿰口彦
笘	true	笘
匧	true	匧
𡧮	true	𡧮
蛧	false	⿰虫网
即	true	即
飼	false	⿰飠司
嵒	true	嵒
喦	true	喦
㸏	false	⿸靡火
緁	false	⿰糹疌
八	true	八
糂	true	糂
噞	true	噞
紅	true	紅
樴	true	樴
韜	true	韜
荼	true	荼
趣	true	趣
䋁	false	⿰糹亢
禌	false	⿰礻兹
圣	true	圣
賣	true	賣
朹	true	朹
削	true	削
衍	false	衍
冫	false	冫
亂	true	亂
矯	true	矯
塙	true	塙
禪	true	禪
尤	true	尤
士	true	士
紟	true	紟
安	true	安
兢	true	兢
茞	true	茞
鼴	false	⿰鼠匽
外	true	外
㬹	false	⿰月争
脧	false	⿰月⿳厶八夂
盲	true	盲
倓	true	倓
㗴	false	⿰口閒
犀	false	犀
驛	true	驛
夲	false	夲
阠	true	阠
𦬫	false	𦬫
貍	true	貍
乙	true	乙
䍮	true	䍮
餬	false	⿰飠胡
喑	true	喑
㭭	false	⿰木别
鈭	true	鈭
憮	true	憮
儈	true	儈
道	true	道
券	false	⿱龹刀
衂	false	⿰血刃
喳	false	⿰口查
銏	false	⿰金册
伐	true	伐
琤	false	⿰王争
䲊	false	⿰魚隋
鉼	false	⿰金并
餌	false	⿰飠耳
䴳	false	⿰麥穴
霸	true	霸
睞	true	睞
蒹	true	蒹
鍳	false	⿱⿰臣⿱𠂉丶金
還	true	還
龕	true	龕
廚	true	廚
礐	true	礐
翏	true	翏
冥	false	冥
㑒	false	㑒
袀	false	⿰衤匀
晧	false	⿰日告
豦	true	豦
賂	true	賂
蘇	true	蘇
鶌	true	鶌
葷	true	葷
乎	true	乎
尐	false	⿱小乀
腃	false	⿰月⿱龹㔾
褱	false	⿳亠⿱罒⑤𧘇
异	false	⿱巳廾
堛	true	堛
𣦼	true	𣦼
靠	false	⿱告非
貺	true	貺
吂	false	吂
䴭	false	⿰麥才
鮨	true	鮨
酓	true	酓
駒	true	駒
祓	false	⿰礻⿺友丶
伎	true	伎
溓	true	溓
䙵	false	⿱覀圭
遷	false	⿺辶⿱䙲巳
徐	true	徐
寳	false	寳
禒	false	⿰礻彖
凶	true	凶
夆	false	夆
瓜	true	瓜
沗	false	⿱天氺
魵	true	魵
續	true	續
歺	true	歺
傓	true	傓
画	false	⿱一⿶凵田
萬	true	萬
鎧	true	鎧
戻	false	⿸户大
气	true	气
噣	true	噣
粟	false	粟
緥	false	⿰糹保
黙	false	⿱⿰里犬灬
栥	false	⿱次木
祜	true	祜
繣	false	⿰糹畫
畫	true	畫
鬨	true	鬨
助	true	助
餇	false	⿰飠同
鴿	true	鴿
蘸	false	⿱⿻十丨醮
圊	false	⿴囗青
曂	false	⿰日黄
彖	true	彖
麽	false	麽
⑤	false	⑤
膝	false	⿰月桼
禓	false	⿰礻昜
帚	true	帚
緑	false	⿰糹录
墟	false	⿰土虚
嗢	false	⿰口昷
类	false	类
燥	true	燥
荆	false	⿰茾刂
乏	true	乏
筡	true	筡
手	true	手
𡕮	true	𡕮
偃	true	偃
發	true	發
膠	false	⿰月翏
亻	false	亻
肁	false	⿸户聿
豱	false	⿰豕昷
獨	true	獨
瑜	false	⿰王俞
卅	true	卅
絁	false	⿰糹㐌
䊺	false	⿰糹互
黾	false	黾
脹	false	⿰月長
頍	true	頍
㡛	false	⿰巾荒
煢	true	煢
帛	false	帛
脈	false	⿰月𠂢
㸅	false	⿰火⿱竹即
卙	true	卙
侗	true	侗
塀	false	⿰土屏
詁	true	詁
癹	true	癹
在	true	在
韞	false	⿰韋昷
伸	true	伸
兕	true	兕
俁	true	俁
舍	true	舍
燹	true	燹
娽	false	⿰女录
䵋	false	⿰黄有
僾	true	僾
嗃	true	嗃
叨	true	叨
紀	false	⿰糹己
心	true	心
䴟	false	⿸鹿凡
滶	true	滶
俟	true	俟
䬬	false	⿰飠央
紗	false	⿰糹少
兜	true	兜
鷸	true	鷸
敳	true	敳
夨	true	夨
臄	false	⿰月豦
糺	false	⿰糹乚
曰	true	曰
曓	false	⿳𣅽大夲
儻	true	儻
軘	true	軘
綄	false	⿰糹完
咎	true	咎
胭	false	⿰月因
䇒	false	⿱既立
肰	false	⿰月犬
枌	true	枌
胷	false	⿱匈月
斯	true	斯
䏴	false	⿰月肖
脀	false	⿱丞月
㪔	false	⿰林攴
虞	false	⿸虍吴
夅	false	夅
冎	true	冎
綖	false	⿰糹⿺廴⿱丿③
芲	false	⿳⿻十丨人𠤎
柔	false	⿱矛木
瓴	true	瓴
睘	true	睘
覀	false	覀
曈	true	曈
䴶	false	⿰麥夆
䉛	false	⿱竹奥
鮀	true	鮀
歿	true	歿
㬐	false	⿰日晋
樞	true	樞
𦎫	true	𦎫
奻	true	奻
欄	false	⿰木闌
宂	false	⿱宀几
驔	true	驔
線	false	⿰糹泉
蒦	false	⿱⿻十丨隻
氾	true	氾
鱜	false	⿰魚鄉
蹻	true	蹻
謀	true	謀
僇	true	僇
徵	false	徵
嬋	true	嬋
䵀	false	⿰麥𧴪
傿	true	傿
湆	true	湆
嬾	false	⿰女頼
騺	false	⿱執馬
禤	false	⿰礻⿱罒羽
誘	true	誘
高	true	高
六	true	六
臛	false	⿰月霍
教	true	教
爾	true	爾
翊	true	翊
睿	false	睿
騰	true	騰
慅	true	慅
㪜	false	⿰耑攴
冀	true	冀
忒	false	忒
蚩	false	蚩
牃	false	牃
建	false	建
遣	false	遣
蜻	false	⿰虫青
語	true	語
豆	true	豆
正	true	正
湖	true	湖
麅	false	⿸鹿包
免	false	⿱𠂊⑤
碣	true	碣
借	true	借
祽	false	⿰礻卒
魖	false	⿺鬼虚
務	false	⿰矛务
桄	true	桄
喘	true	喘
頤	false	⿰𦣞頁
㒸	true	㒸
器	true	器
潢	false	⿰氵黄
時	true	時
卬	true	卬
鴲	true	鴲
怳	true	怳
學	true	學
蘭	true	蘭
胃	true	胃
具	true	具
儆	true	儆
掫	true	掫
憲	false	⿳𫲸罒心
善	true	善
媅	true	媅
肉	true	肉
屑	true	屑
惎	true	惎
勘	true	勘
瘉	false	⿸疒俞
宿	false	宿
縰	false	⿰糹徙
丙	true	丙
劵	false	⿱龹力
強	true	強
卧	false	卧
儵	true	儵
鴜	true	鴜
稽	true	稽
膵	false	⿰月萃
但	true	但
除	true	除
麲	false	⿰麥見
卋	false	卋
䏞	false	⿰月末
橐	true	橐
叡	true	叡
垕	false	⿱后土
𠂉	false	𠂉
綏	false	⿰糹妥
風	true	風
機	true	機
繢	false	⿰糹貴
疒	true	疒
事	true	事
森	true	森
矇	true	矇
土	true	土
膒	false	⿰月區
十	true	十
腋	false	⿰月夜
昬	false	昬
戇	true	戇
領	true	領
斷	true	斷
丐	true	丐
騏	true	騏
捈	true	捈
𣈅	false	𣈅
嚒	false	⿰口麼
枸	true	枸
溦	false	⿰氵𢼸
脜	false	⿰月𦣻
蝱	true	蝱
夷	true	夷
懊	false	⿰忄奥
䏧	false	⿰月多
鷢	false	⿸厥鳥
鱀	false	⿱既魚
也	true	也
肟	false	⿰月亏
悄	true	悄
役	true	役
煩	true	煩
葚	true	葚
縘	false	⿰糹奚
示	true	示
餹	false	⿰飠⿸广⿱肀口
擐	true	擐
䋪	false	⿰糹阿
椵	true	椵
昫	true	昫
儀	true	儀
嘾	true	嘾
珣	true	珣
濛	true	濛
栩	true	栩
璫	true	璫
尔	false	尔
䏖	false	⿰月引
儰	false	⿰亻蔿
韏	false	⿱龹韋
欱	true	欱
沱	true	沱
縿	true	縿
矞	true	矞
果	false	果
黠	true	黠
璁	false	⿰王悤
酣	true	酣
郜	false	⿰告阝
殶	false	⿰主殳
叉	true	叉
黃	true	黃
別	true	別
総	false	⿰糹忩
戰	true	戰
䁊	false	⿰目⿱叉目
蹌	true	蹌
酒	false	酒
奂	false	奂
洵	true	洵
故	true	故
籣	true	籣
踳	true	踳
訕	true	訕
䋐	false	⿰糹戉
鄫	true	鄫
觷	true	觷
𨔝	true	𨔝
𧘇	false	𧘇
箯	true	箯
蜀	true	蜀
乚	false	乚
䏥	false	⿰月冉
継	false	⿰糹⿺𠃊米
践	false	⿰𧾷戋
腥	false	⿰月星
鄛	true	鄛
子	true	子
繷	false	⿰糹農
漷	true	漷
蜭	true	蜭
卒	true	卒
眈	true	眈
䉾	true	䉾
屏	false	屏
熇	true	熇
秜	true	秜
䭒	false	⿰飠息
桒	false	⿱卉木
壹	true	壹
筮	true	筮
祰	false	⿰礻告
臞	false	⿰月瞿
起	true	起
戈	true	戈
脪	false	⿰月希
靦	true	靦
𧡪	true	𧡪
𦥑	false	𦥑
絇	true	絇
䐘	false	⿰月爰
傳	true	傳
叛	true	叛
聰	false	⿰耳悤
䄌	false	⿰礻叕
紁	false	⿰糹叉
岩	true	岩
⺀	false	⺀
袪	true	袪
架	false	⿱加木
犮	false	⿺友丶
𧘂	true	𧘂
方	true	方
艸	true	艸
資	true	資
結	false	⿰糹吉
媵	false	⿰月⿱龹女
怱	false	怱
𡭐	true	𡭐
箇	true	箇
轒	true	轒
弔	true	弔
畔	true	畔
胺	false	⿰月安
拉	true	拉
㔢	false	⿱⿰糹色力
恰	true	恰
旡	true	旡
襑	true	襑
晹	true	晹
奠	true	奠
臌	false	⿰月鼓
鼹	false	⿰鼠晏
縍	false	⿰糹旁
絀	false	⿰糹出
仕	true	仕
妹	true	妹
䤁	true	䤁
窀	true	窀
佮	true	佮
裕	true	裕
丵	true	丵
䭠	false	⿰飠廉
胆	false	⿰月旦
舞	true	舞
甾	false	甾
雒	true	雒
三	true	三
鶾	false	⿰𠦝⿱𠂉鳥
㗗	false	⿰另卑
𠑷	false	𠑷
苦	true	苦
像	true	像
芆	false	⿱⿻十丨叉
櫐	false	⿱畾木
㰍	false	⿱龍木
聙	false	⿰耳青
佰	true	佰
飢	false	⿰飠几
楅	true	楅
瘖	true	瘖
洛	true	洛
鄆	true	鄆
䜌	true	䜌
頝	false	頝
巿	true	巿
頭	true	頭
目	true	目
倘	false	⿰亻尚
肢	true	肢
湛	true	湛
𠘧	false	𠘧
鈴	true	鈴
𥃩	true	𥃩
䀹	false	⿰目夾
就	true	就
付	true	付
㸂	false	⿱遂火
䄉	false	⿰礻我
礣	false	⿰石⿱𦭝戍
友	true	友
肈	false	⿱𫼉聿
饋	false	⿰飠貴
肷	false	⿰月欠
儽	true	儽
敬	true	敬
祏	true	祏
立	true	立
猌	true	猌
疝	true	疝
祹	false	⿰礻匋
遃	false	⿺辶彦
区	false	⿷匚㐅
肕	false	⿰月刃
渾	true	渾
綣	false	⿰糹⿱龹㔾
睡	true	睡
騶	true	騶
訊	true	訊
嬮	false	⿸厭女
㭕	true	㭕
臎	false	⿰月翠
嬴	true	嬴
㧂	false	⿸户田
荒	true	荒
䔪	false	⿱⿻十丨爽
圂	true	圂
儺	true	儺
芝	true	芝
匾	false	⿷匚⿸户𠕁
楂	false	⿰木查
癀	false	⿸疒黄
娷	true	娷
丸	true	丸
梨	true	梨
諯	true	諯
腠	false	⿰月奏
鞝	false	⿰革尚
嚴	true	嚴
珊	false	⿰王册
戚	false	戚
般	true	般
櫱	false	⿱辥木
霿	false	⿱雨⿰矛⿱夂目
長	true	長
釆	true	釆
絯	false	⿰糹亥
固	true	固
儋	true	儋
膉	false	⿰月⿱⿱䒑八皿
劀	true	劀
僑	true	僑
暗	true	暗
伴	true	伴
骴	true	骴
觸	true	觸
章	true	章
彳	true	彳
含	true	含
餒	false	⿰飠妥
䴼	false	⿰麥戔
䏾	false	⿰月奉
鬲	true	鬲
鵠	false	⿰告鳥
𡭴	false	𡭴
棻	false	⿱芬木
詗	true	詗
緘	false	⿰糹咸
而	true	而
肫	true	肫
𡇒	true	𡇒
絅	true	絅
兟	true	兟
麵	true	麵
絋	false	⿰糹広
憁	false	⿰忄悤
㞊	false	⿰祟尢
䵎	false	⿰黄耑
餘	true	餘
蒪	false	蒪
獫	true	獫
厧	false	⿸厂真
琭	false	⿰王录
隱	false	隱
仇	true	仇
狼	true	狼
殸	true	殸
佇	true	佇
綾	false	⿰糹夌
粱	true	粱
賽	true	賽
絠	false	⿰糹有
豐	true	豐
巽	false	⿱⿰巳巳共
詣	true	詣
哯	true	哯
絶	false	⿰糹色
皃	false	皃
麗	false	麗
繲	false	⿰糹解
仳	true	仳
肌	false	⿰月几
貘	true	貘
栔	true	栔
剏	false	⿰并刃
俗	true	俗
庳	false	庳
郎	true	郎
咸	true	咸
妗	true	妗
巂	true	巂
員	true	員
慟	true	慟
冰	true	冰
憈	false	⿰忄虚
嬙	true	嬙
㮝	false	⿰木卻
敕	true	敕
䮧	false	⿰𠦝⿱𠂉馬
脻	false	⿰月疌
餠	false	⿰飠幷
亇	false	⿱𠂊亅
顨	false	⿱𩔊丌
與	true	與
攴	true	攴
白	true	白
䐧	false	⿰月高
桼	false	桼
祦	false	⿰礻吴
室	true	室
綥	false	⿰糹畀
寺	true	寺
経	false	⿰糹圣
癇	true	癇
礿	true	礿
顔	true	顔
鼨	true	鼨
緟	true	緟
考	true	考
麺	false	⿰麦面
齒	false	齒
禂	false	⿰礻周
臟	false	⿰月藏
㯶	false	⿰木𡕰
𠥐	true	𠥐
禑	false	⿰礻禺
脣	false	⿸辰月
漑	false	⿰氵旣
朡	false	⿰月㚇
噊	true	噊
桋	true	桋
鼶	false	⿰鼠虒
生	true	生
膴	true	膴
䴱	false	⿰麥它
掌	true	掌
酉	true	酉
飦	false	⿰飠干
徒	true	徒
蝎	true	蝎
戔	false	戔
笏	true	笏
覜	true	覜
油	true	油
給	true	給
延	false	⿺廴⿱丿③
兮	true	兮
膌	false	⿰月脊
椋	true	椋
氿	true	氿
彉	false	⿰弓黄
廇	false	⿸广留
豪	true	豪
虄	false	⿱⿻十丨⿰虫⿱夂産
祣	false	⿰礻⿱𠂉④
葭	true	葭
争	false	争
消	true	消
絖	true	絖
臯	false	⿱自𠦂
𪧷	false	𪧷
䈂	false	⿱竹并
胇	false	⿰月弗
侈	true	侈
鼥	false	⿰鼠⿺友丶
茣	false	⿱⿻十丨吴
餱	false	⿰飠侯
坐	false	坐
縫	false	⿰糹逢
菁	false	⿱⿻十丨青
縦	false	⿰糹従
痟	true	痟
上	true	上
覺	true	覺
丞	true	丞
䩻	false	䩻
𠬝	false	𠬝
史	true	史
喬	true	喬
世	true	世
䨙	false	⿱雨𭯺
胯	false	⿰月夸
仔	true	仔
膹	true	膹
詻	true	詻
說	true	說
𥹄	false	𥹄
䢅	false	⿱臼辰
科	true	科
㚅	false	㚅
郵	true	郵
胄	false	⿱由月
烙	true	烙
悤	true	悤
鍜	true	鍜
匓	false	⿹勹⿰⑤殳
桊	false	⿱𠔉木
鎬	true	鎬
䃣	false	⿰石爲
報	true	報
默	true	默
惲	true	惲
䯠	false	⿰骨昷
舟	true	舟
秦	true	秦
卩	true	卩
豽	false	⿰豸内
王	true	王
羭	false	⿰羊俞
臈	false	⿰月葛
牝	true	牝
懐	false	⿰忄⿱亠𭾱
邪	true	邪
卿	true	卿
穨	false	⿰秃貴
𨜴	true	𨜴
絺	false	⿰糹希
寨	false	⿱𡨄木
弟	false	弟
動	true	動
魂	true	魂
朅	true	朅
鈐	true	鈐
量	true	量
對	true	對
地	true	地
均	false	⿰土匀
伹	true	伹
彝	true	彝
濇	true	濇
雂	true	雂
廐	false	⿸广既
啍	true	啍
笠	true	笠
鐄	false	⿰金黄
票	true	票
芮	false	⿱⿻十丨内
健	true	健
腘	false	⿰月国
翬	true	翬
䩗	false	䩗
狟	true	狟
緢	false	⿰糹苗
䑌	false	⿰月闌
陋	true	陋
黄	true	黄
繧	false	⿰糹雲
緉	false	⿰糹兩
允	true	允
夌	true	夌
㸐	false	㸐
蕁	true	蕁
穔	false	⿰禾黄
絛	false	⿰⿰亻丨⿱夂糸
祚	true	祚
脿	false	⿰月表
䐢	false	⿰月芻
嫸	true	嫸
舓	true	舓
紂	false	⿰糹寸
昵	true	昵
臍	false	⿰月齊
䌥	false	⿰糹㥯
獚	false	⿰犭黄
謓	false	⿰言真
熈	false	熈
雌	true	雌
腇	false	⿰月委
諍	false	⿰言争
歱	true	歱
戎	true	戎
扔	true	扔
僥	true	僥
丩	true	丩
𬀷	false	𬀷
鷗	true	鷗
縑	true	縑
棊	false	⿱其木
舒	true	舒
綿	false	⿰糹帛
咨	true	咨
㧊	false	⿰扌巿
袍	true	袍
紌	false	⿰糹尤
叕	true	叕
赫	true	赫
敦	true	敦
䏠	false	⿰月立
𤔌	false	𤔌
亠	true	亠
趟	false	⿺走尚
縖	false	⿰糹⿱𫲸口
瓊	false	⿰王⿳⿱𠂊𠔿目夂
䐱	false	⿰月啇
願	true	願
剬	true	剬
蚤	true	蚤
嬥	true	嬥
向	true	向
䐂	false	⿰月录
骿	false	⿰骨并
巩	false	⿰工凡
餩	false	⿰飠⿱人亥
促	true	促
敖	true	敖
鵅	true	鵅
脂	true	脂
鼧	false	⿰鼠它
澳	false	⿰氵奥
尼	true	尼
𥞤	false	𥞤
㝹	false	⿱少兔
牟	true	牟
冣	true	冣
蠲	true	蠲
侅	true	侅
匘	true	匘
品	true	品
䐥	false	⿰月翁
甚	true	甚
腊	false	⿰月昔
礽	false	⿰礻乃
彈	true	彈
沖	true	沖
𧴪	false	𧴪
巤	true	巤
租	true	租
𢺵	true	𢺵
奊	false	奊
鏖	false	⿸鹿金
臚	false	⿰月盧
析	false	析
洽	true	洽
虔	true	虔
偓	true	偓
縌	false	⿰糹逆
馧	false	⿰香𥁕
倭	true	倭
処	true	処
蒼	true	蒼
臢	false	⿰月贊
戊	true	戊
乾	true	乾
伂	false	⿰亻巿
射	false	射
逾	false	⿺辶俞
薌	true	薌
狗	true	狗
瞋	false	⿰目真
幝	true	幝
掽	false	⿰扌並
玼	true	玼
完	false	完
嫹	false	⿰女黄
扂	false	⿸户占
緒	false	⿰糹者
鞹	true	鞹
宄	true	宄
䱁	false	⿰魚本
嘆	false	⿰口⿱廿⿻口夫
謨	true	謨
饛	true	饛
忿	true	忿
䭀	false	⿰飠迅
餀	false	⿰飠艾
鑝	false	⿰金⿺辶莑
湅	true	湅
匐	true	匐
𬗌	false	𬗌
蘈	false	⿱⿻十丨頽
轘	true	轘
䣊	false	⿰尚阝
豊	true	豊
犕	true	犕
企	true	企
肦	false	⿰⺼分
皿	true	皿
然	true	然
什	true	什
鹿	true	鹿
竷	true	竷
朗	false	⿰⿱丶⑤月
裼	true	裼
雰	true	雰
焉	true	焉
靜	false	⿰青爭
伊	true	伊
條	false	⿰⿰亻丨⿱夂朩
冐	false	⿱冃月
餵	false	⿰飠畏
溫	true	溫
窨	true	窨
䐅	false	⿰月𡱁
禁	false	禁
糱	false	⿱辥米
敄	false	敄
殿	true	殿
閙	false	⿵門市
享	true	享
柤	true	柤
仆	true	仆
㔶	true	㔶
𦣻	false	𦣻
桬	false	⿱沙木
膱	false	⿰月戠
紺	true	紺
牄	true	牄
膗	false	⿰月崔
紋	false	⿰糹文
危	true	危
丌	true	丌
麥	true	麥
圜	true	圜
謹	false	⿰言堇
紻	false	⿰糹央
齄	false	⿰鼻查
亥	true	亥
禎	true	禎
扆	false	⿸户衣
鰒	true	鰒
綗	false	⿰糹冏
棃	false	⿱𥝢木
沭	false	⿰氵术
稌	true	稌
繻	false	⿰糹需
嗇	true	嗇
宬	true	宬
雚	true	雚
濿	true	濿
灬	false	灬
䍇	true	䍇
腔	false	⿰月空
炉	false	⿰火户
咀	true	咀
嵹	false	⿱山强
捩	false	⿰扌⿸户犬
匰	true	匰
皸	true	皸
靚	false	⿰青見
滈	true	滈
纙	false	⿰糹羅
郘	false	⿰吕阝
䑋	false	⿰月襄
汋	true	汋
䤚	false	⿰月里
栠	false	⿱任木
吴	false	吴
步	false	步
嬰	false	嬰
杗	true	杗
致	true	致
苟	true	苟
躺	false	⿰身尚
䊾	false	⿰糹木
釦	true	釦
擁	true	擁
靮	true	靮
霄	true	霄
儦	true	儦
偐	false	⿰亻彦
蹇	true	蹇
武	true	武
厚	true	厚
洫	true	洫
爻	true	爻
錚	false	⿰金争
歉	true	歉
眴	true	眴
蜆	true	蜆
㳛	false	⿰氵臾
䖄	false	⿱⿻十丨㸐
稿	true	稿
甑	true	甑
揠	true	揠
玕	true	玕
浙	true	浙
旣	false	旣
胕	false	⿰月付
弋	true	弋
忽	true	忽
帖	true	帖
傴	true	傴
膛	false	⿰月堂
耑	true	耑
户	false	户
匀	false	匀
同	true	同
嬌	true	嬌
鐺	true	鐺
守	true	守
黏	true	黏
靘	false	⿰青色
甘	true	甘
負	false	負
賚	true	賚
怚	true	怚
印	true	印
縅	false	⿰糹威
駕	true	駕
絹	false	⿰糹⿱口月
冭	false	⿱大⺀
瘼	true	瘼
脤	false	⿰月辰
𠕁	false	𠕁
牿	false	⿰牛告
翯	true	翯
麶	false	⿰麥离
利	true	利
删	false	删
贅	true	贅
𤕦	true	𤕦
渠	true	渠
橤	false	⿱惢木
奧	false	奧
以	true	以
崳	false	⿰山俞
阿	false	阿
纎	false	⿰糹韯
缾	false	⿰缶并
齃	true	齃
蔁	true	蔁
纔	false	⿰糹毚
篸	true	篸
斟	true	斟
研	true	研
絩	true	絩
餛	false	⿰飠昆
旦	true	旦
何	true	何
列	true	列
倡	true	倡
餳	false	⿰飠昜
至	true	至
楬	true	楬
飣	false	⿰飠丁
俈	false	⿰亻告
絗	false	⿰糹回
柬	true	柬
刎	true	刎
鶄	false	⿰青鳥
悉	true	悉
銊	false	⿰金戌
革	true	革
䐇	false	⿰月曶
䟍	false	⿺走臱
到	true	到
馿	false	⿰馬户
屎	true	屎
冊	true	冊
誚	true	誚
萺	true	萺
歸	true	歸
露	true	露
巟	true	巟
昨	true	昨
丂	true	丂
尿	true	尿
癉	true	癉
䐁	false	⿰月豖
𡕰	false	𡕰
踰	false	⿰𧾷俞
胒	false	⿰月尼
婙	false	⿰女争
蚐	false	⿰虫匀
冋	true	冋
圖	true	圖
繑	true	繑
䴹	false	⿰麥果
愉	false	⿰忄俞
脞	false	⿰月坐
賵	true	賵
復	true	復
珧	true	珧
緩	false	⿰糹爰
嗛	true	嗛
檃	false	⿱⿰阝𤔌木
臉	false	⿰月僉
供	true	供
繯	true	繯
鞄	true	鞄
晟	true	晟
爲	false	爲
賜	true	賜
贍	true	贍
䐈	false	⿰月直
膀	false	⿰月旁
紏	false	⿰糹斗
紛	true	紛
眉	true	眉
指	true	指
兆	true	兆
媰	true	媰
夎	false	⿱坐夂
缶	true	缶
申	true	申
𧈸	false	𧈸
腡	false	⿰月咼
遹	true	遹
黊	false	⿰黄圭
黑	true	黑
茖	true	茖
媺	false	⿰女𢼸
𢾰	false	𢾰
僅	true	僅
䄍	false	⿰礻昔
濆	true	濆
眾	false	⿱罒乑
餿	false	⿰飠⿱⿻臼丨又
妠	false	⿰女内
例	true	例
歇	true	歇
隨	true	隨
膣	false	⿰月窒
檍	true	檍
阜	true	阜
浪	true	浪
麍	false	⿸鹿㐬
鸔	true	鸔
璥	true	璥
埵	true	埵
憸	true	憸
卓	false	卓
拄	false	⿰扌主
蟷	true	蟷
蕡	true	蕡
扄	false	⿸户向
幕	true	幕
荀	true	荀
棨	false	⿱𢼄木
梅	false	⿰木每
空	true	空
鯖	false	⿰魚青
胤	false	⿲丿⿱幺月乚
腤	false	⿰月音
倃	true	倃
每	true	每
職	true	職
憼	true	憼
賀	true	賀
鄦	true	鄦
惕	true	惕
䎑	false	⿰羽录
脺	false	⿰月卒
倢	true	倢
幢	true	幢
嫌	true	嫌
抌	true	抌
側	true	側
繞	false	⿰糹堯
姬	false	⿰女𦣞
𣥹	true	𣥹
閷	false	⿰杀閃
棐	false	⿱非木
肝	false	⿰月干
㚓	false	⿱大木
綬	false	⿰糹受
蝹	false	⿰虫昷
斉	false	斉
扚	true	扚
侶	true	侶
氝	false	⿹气内
牙	true	牙
甬	true	甬
入	true	入
䩞	true	䩞
噅	false	⿰口爲
㟟	false	⿱山⿱共巳
㵪	false	⿰氵羡
湊	true	湊
禺	true	禺
犟	false	⿱强牛
宔	false	⿱宀主
圀	false	⿴囗⿱八方
㛴	true	㛴
次	true	次
貳	true	貳
督	true	督
驀	true	驀
燒	true	燒
冓	true	冓
竦	true	竦
衫	true	衫
洶	true	洶
甜	true	甜
靹	false	⿰革内
纝	false	⿰糹纍
𣪠	false	𣪠
顗	true	顗
䴷	false	⿰麥完
簞	true	簞
諈	true	諈
塍	false	⿰月⿱龹土
都	true	都
艹	false	艹
萈	true	萈
佗	true	佗
丘	true	丘
傑	true	傑
禊	false	⿰礻契
藑	false	⿱⿻十丨⿳⿱𠂊𠔿目夂
墺	false	⿰土奥
歆	true	歆
鬕	true	鬕
酷	false	⿰酉告
公	true	公
級	true	級
俳	true	俳
芻	true	芻
軌	true	軌
敏	false	⿰每攵
躅	true	躅
檀	true	檀
渴	true	渴
責	false	責
刃	true	刃
遘	true	遘
朙	true	朙
桓	true	桓
巫	true	巫
罟	true	罟
謁	true	謁
晏	false	晏
笉	false	⿱竹匀
郕	true	郕
着	false	⿸羊目
甹	true	甹
搷	false	⿰扌真
禡	false	⿰礻馬
褕	false	⿰衤俞
飴	false	⿰飠台
習	false	習
癘	true	癘
襖	false	⿰衤奥
砧	true	砧
詑	true	詑
湩	true	湩
攧	false	⿰扌顛
寍	true	寍
臏	false	⿰月⿱⿱宀⿱一𣥂貝
差	true	差
柅	true	柅
匵	true	匵
噓	true	噓
乀	false	乀
纆	false	⿰糹⿱黑土
鷻	true	鷻
㕓	false	㕓
繩	false	⿰糹黽
䒑	false	䒑
滇	false	⿰氵真
碬	true	碬
膕	false	⿰月國
稹	false	⿰禾真
㛉	false	⿰女覀
鈍	true	鈍
禽	true	禽
篰	true	篰
脖	false	⿰月孛
念	true	念
䌞	false	⿰糹僉
矰	true	矰
䌭	false	⿰糹蕉
赴	true	赴
介	true	介
撟	true	撟
嫏	false	⿰女郎
組	true	組
繗	false	⿰糹粦
綃	true	綃
洍	false	⿰氵𦣞
響	true	響
纜	false	⿰糹覽
亍	true	亍
二	true	二
麧	false	⿰麥乞
覙	false	⿰尓見
輅	true	輅
䟿	false	⿰𧾷录
餣	false	⿰飠奄
頿	true	頿
版	true	版
术	false	术
臼	true	臼
干	true	干
卯	true	卯
鮆	true	鮆
匩	false	⿷匚𡉚
誊	false	誊
黍	true	黍
祟	false	祟
㶳	false	⿱⿱𦘒一火
贕	false	⿰卵賣
䐕	false	⿰月咠
䝼	false	⿰貝青
丕	true	丕
纐	false	⿰糹頝
㫐	true	㫐
黈	false	⿰黄主
屯	true	屯
紘	false	⿰糹厷
絓	false	⿰糹圭
舊	false	⿱萑臼
炙	false	⿱⿴𠂊⺀火
綫	false	⿰糹戔
潕	true	潕
縇	false	⿰糹宣
黹	true	黹
䋂	false	⿰糹爻
柋	false	⿱代木
忱	true	忱
萊	true	萊
㒳	true	㒳
晛	true	晛
䐬	false	⿰月曹
軀	true	軀
㐭	true	㐭
菆	true	菆
胟	false	⿰月母
槷	false	⿱埶木
并	false	并
姦	true	姦
緋	false	⿰糹非
縼	false	⿰糹旋
因	true	因
祄	false	⿰礻介
碎	true	碎
靌	false	⿱雨寳
纍	false	纍
爵	false	⿳⿱丿𭕄罒𡬠
絎	false	⿰糹行
社	true	社
絑	false	⿰糹朱
邠	true	邠
腨	false	⿰月耑
筽	false	⿱竹吴
泥	true	泥
嵩	true	嵩
閬	true	閬
單	true	單
餐	true	餐
畀	false	畀
㚲	true	㚲
貝	true	貝
呬	true	呬
物	true	物
睍	true	睍
鬥	true	鬥
茈	true	茈
沮	true	沮
緌	false	⿰糹委
略	true	略
胶	false	⿰月交
皶	false	⿰查皮
恭	true	恭
警	true	警
羔	false	羔
酳	false	⿰酉⿱幺月
泚	true	泚
綂	false	⿰糹𠑽
絭	false	⿱龹糸
伶	true	伶
夂	true	夂
搔	true	搔
規	false	規
沿	false	⿰氵⿱几口
掐	true	掐
闤	true	闤
𦣞	false	𦣞
芬	true	芬
䐠	false	⿰月荒
潭	true	潭
件	true	件
𪪷	false	𪪷
蓈	false	⿱⿻十丨郎
肤	false	⿰月夫
媢	true	媢
耽	true	耽
鴆	true	鴆
䐯	false	⿰月累
傪	true	傪
酏	true	酏
拈	true	拈
㘝	true	㘝
苳	true	苳
瑢	false	⿰王容
夊	true	夊
侉	true	侉
氏	true	氏
緷	true	緷
罝	true	罝
瑁	true	瑁
亨	false	亨
臙	false	⿰月燕
㠲	true	㠲
祀	false	⿰礻巳
絏	false	⿰糹曳
靗	false	⿰青光
备	false	备
啐	true	啐
塭	false	⿰土昷
䈀	false	⿱竹删
祥	false	⿰礻羊
臗	false	⿰月⿱宀萈
匜	true	匜
絰	false	⿰糹至
誻	true	誻
令	true	令
忩	false	忩
䏌	false	⿱八月
𡉚	false	𡉚
妾	true	妾
听	true	听
豭	true	豭
樂	true	樂
黅	false	⿰黄今
絼	false	⿰糹豸
杶	true	杶
駱	true	駱
嗞	false	⿰口兹
絽	false	⿰糹吕
饆	false	⿰飠畢
里	true	里
緻	false	⿰糹致
麹	false	⿰麦匊
棄	false	⿱𠫓⿻廿木
脃	false	⿰月色
齡	true	齡
胮	false	⿰月夅
燕	false	燕
翁	false	翁
囊	true	囊
崖	true	崖
𦭝	false	𦭝
黔	true	黔
瓯	false	⿰⿷匚㐅瓦
賦	true	賦
謡	false	⿰言⿱⿱丿𭕄缶
腧	false	⿰月俞
儼	true	儼
仿	true	仿
雹	true	雹
縴	false	⿰糹牽
膨	false	⿰月彭
鋘	false	⿰金吴
縣	true	縣
縛	false	⿰糹尃
妄	true	妄
苓	true	苓
勗	false	⿱日助
芃	true	芃
思	true	思
疉	false	⿳畾冖彑
囪	true	囪
劋	true	劋
蕪	true	蕪
撣	true	撣
㓘	false	⿵夙玉
碀	false	⿰石争
圭	false	圭
僰	true	僰
鿫	false	⿹气奥
胂	false	⿰月申
惢	false	惢
弈	true	弈
址	true	址
侯	true	侯
郾	true	郾
鎌	true	鎌
漳	true	漳
柘	true	柘
糴	true	糴
紲	false	⿰糹世
祩	false	⿰礻朱
爋	false	⿰火勳
采	true	采
憎	true	憎
紇	false	⿰糹乞
俶	true	俶
九	true	九
綱	false	⿰糹岡
斫	true	斫
欺	true	欺
好	true	好
網	false	⿰糹罔
䐷	false	⿰月單
祧	true	祧
䛢	false	⿰言秃
成	true	成
墀	false	⿰土犀
寇	true	寇
副	true	副
韯	false	韯
簟	true	簟
蜈	false	⿰虫吴
汧	false	⿰氵开
緣	true	緣
璪	true	璪
豶	true	豶
蚋	false	⿰虫内
㕣	false	㕣
爫	false	⿱丿𭕄
橋	true	橋
鶡	true	鶡
觮	false	⿰角录
欤	false	⿰与欠
䡊	true	䡊
槪	false	⿰木旣
腴	false	⿰月臾
饙	true	饙
羅	false	羅
嚳	true	嚳
羖	true	羖
賴	false	⿰束負
術	false	⿲彳术亍
脥	false	⿰月夾
倫	true	倫
紑	false	⿰糹不
晢	true	晢
帶	false	帶
嚚	true	嚚
鼢	true	鼢
兇	true	兇
紝	false	⿰糹壬
聲	true	聲
百	true	百
綴	true	綴
絔	false	⿰糹百
蘠	true	蘠
肭	false	⿰月内
竹	true	竹
𤸱	true	𤸱
犢	true	犢
𩔊	false	𩔊
秃	false	秃
驢	true	驢
岨	true	岨
鴣	true	鴣
㟋	false	⿰山兑
市	true	市
橝	true	橝
筤	true	筤
沓	true	沓
館	true	館
蒬	true	蒬
捗	false	⿰扌步
厩	false	⿸厂既
侑	true	侑
礻	false	礻
迆	true	迆
𦓝	true	𦓝
䄅	false	⿱龹示
阤	true	阤
𬛸	false	𬛸
蕉	true	蕉
䏎	false	⿰月凡
蒙	true	蒙
䑏	false	⿰月雚
菊	true	菊
兼	true	兼
角	true	角
毆	true	毆
粗	true	粗
脁	true	脁
胛	false	⿰月甲
癲	false	⿸疒顛
曶	true	曶
棷	true	棷
黇	true	黇
臭	false	⿱自犬
癸	true	癸
䏵	false	⿰月⿷尤彡
䕈	false	⿱⿻十丨牃
膔	false	⿰月鹿
睮	false	⿰目俞
豈	true	豈
糒	false	⿰米𤰇
脽	false	⿰月隹
重	true	重
顓	true	顓
槁	true	槁
禖	true	禖
祿	false	⿰礻彔
麩	false	⿰麥夫
蔥	false	⿱⿻十丨悤
祈	false	⿰礻斤
韇	true	韇
丿	true	丿
斃	true	斃
㥯	false	㥯
醮	false	醮
敷	false	⿰旉攵
蝆	false	⿰虫芈
囶	false	⿴囗𡉀
冏	true	冏
鼦	false	⿰鼠召
黟	true	黟
膜	true	膜
鼵	false	⿰鼠突
冗	false	冗
栄	false	⿳𭕄冖木
拘	true	拘
黕	true	黕
朸	true	朸
絕	true	絕
䐮	false	⿰月産
竊	true	竊
啔	false	⿱𫼉口
鼱	false	⿰鼠青
耴	true	耴
憬	true	憬
憰	true	憰
叒	true	叒
綜	false	⿰糹宗
愊	true	愊
敲	true	敲
屍	true	屍
𣥂	false	𣥂
㝉	false	㝉
戽	false	⿸户斗
虛	true	虛
涂	true	涂
僩	true	僩
技	true	技
𫲸	false	𫲸
㸒	false	⿱⿱丿𭕄壬
旅	false	旅
肋	true	肋
樊	true	樊
驁	true	驁
丅	true	丅
屵	true	屵
契	true	契
䳴	false	⿰⿱罒⑤鳥
参	false	参
歁	true	歁
瞫	true	瞫
壻	false	⿰士⿱疋月
受	true	受
肱	false	⿰月厷
縪	false	⿰糹畢
輬	true	輬
此	true	此
詢	true	詢
鼻	true	鼻
吻	true	吻
売	false	売
忝	false	⿱天㣺
幅	true	幅
岐	true	岐
院	true	院
腄	true	腄
刱	true	刱
晦	false	⿰日每
統	false	⿰糹充
涵	true	涵
礠	false	⿰石慈
䐃	false	⿰月囷
杒	true	杒
繼	false	⿰糹㡭
容	true	容
凥	true	凥
祾	false	⿰礻夌
餓	false	⿰飠我
旁	false	旁
胝	false	⿰月⿱氏丶
䠢	false	⿳𦭝冖足
辥	false	辥
条	false	⿱夂朩
頓	true	頓
匯	true	匯
尌	true	尌
䐎	false	⿰月是
蟨	false	⿸厥虫
膺	false	⿸䧹月
㼊	false	⿰屯瓜
臱	true	臱
鎗	true	鎗
笱	true	笱
网	true	网
縲	false	⿰糹累
汕	true	汕
錔	true	錔
磏	true	磏
珇	true	珇
箕	true	箕
祌	false	⿰礻中
質	false	質
歈	false	⿰俞欠
又	true	又
酴	true	酴
賁	true	賁
諾	true	諾
梷	false	⿱⿰占又木
爆	true	爆
癶	true	癶
鬳	true	鬳
玓	true	玓
伨	false	⿰亻匀
緄	false	⿰糹昆
丑	true	丑
堯	true	堯
豨	true	豨
暱	true	暱
弘	false	弘
丄	true	丄
折	true	折
權	true	權
僂	true	僂
飰	false	⿰飠卞
肙	false	⿱口月
遭	true	遭
㘨	false	⿰土内
鱼	false	鱼
肔	false	⿰月也
脼	false	⿰月兩
阽	true	阽
齱	true	齱
典	true	典
㭻	false	⿰木尚
䐩	false	⿰月豈
疌	true	疌
祛	false	⿰礻去
覷	false	⿰虚見
奕	true	奕
扃	true	扃
盍	true	盍
璽	false	璽
亢	true	亢
㼶	false	⿰俞瓦
莦	true	莦
趙	true	趙
聠	false	⿰耳并
祉	true	祉
猪	false	猪
䋫	false	⿰糹争
比	true	比
韥	false	⿰韋賣
瑲	true	瑲
鄯	true	鄯
下	true	下
廊	true	廊
羒	true	羒
㝸	false	⿱小皃
畇	false	⿰田勻
麪	false	⿰麥丏
㼔	false	⿰昷瓜
鄩	true	鄩
塞	true	塞
䑎	false	⿰月韱
力	true	力
曷	true	曷
節	false	⿱竹即
駦	false	⿱龹馬
馬	true	馬
亡	true	亡
畬	true	畬
兾	false	⿱丷異
饞	false	⿰飠毚
戍	true	戍
褝	false	⿰衤单
䄄	false	⿰礻因
止	true	止
踸	true	踸
氵	false	氵
𠔿	false	𠔿
木	true	木
噢	false	⿰口奥
祵	false	⿰礻困
臾	true	臾
紵	false	⿰糹宁
吉	true	吉
臿	true	臿
广	true	广
噆	true	噆
䖈	false	⿸虍匕
鴇	true	鴇
鼬	false	⿰鼠由
掘	true	掘
鞰	false	⿰革昷
祺	true	祺
慨	false	⿰忄既
麞	false	⿸鹿章
川	true	川
戹	false	⿸户乙
窕	true	窕
新	true	新
霞	true	霞
夕	true	夕
𫼉	false	𫼉
鼮	false	⿰鼠⿺廴壬
姑	true	姑
凋	true	凋
今	true	今
黛	false	⿱代黑
䬴	false	⿰飠末
須	true	須
訒	true	訒
膃	false	⿰月𥁕
繿	false	⿰糹⿱⿰臣⿱𠂉丶皿
䏡	false	⿰月示
繜	false	⿰糹尊
岸	true	岸
牶	false	⿱龹牛
鼏	true	鼏
跳	true	跳
面	true	面
衰	false	衰
苞	true	苞
頒	true	頒
靝	false	⿰青氣
眇	false	眇
鶵	true	鶵
韱	false	韱
伀	true	伀
炎	false	炎
郒	false	⿰⿱丶⑤邑
靨	false	⿸厭面
囱	false	⿴⿱丿囗夂
禳	false	⿰礻襄
禧	false	⿰礻喜
楙	false	楙
記	true	記
劫	true	劫
佻	true	佻
縄	false	⿰糹⿻日电
秶	true	秶
由	false	由
騫	true	騫
襁	false	⿰衤强
肵	false	⿰月斤
胴	false	⿰月同
腮	false	⿰月思
蘤	false	⿱⿻十丨𤾡
蠓	true	蠓
膓	false	⿰月𬀷
勆	false	⿰⿱丶⑤力
靖	false	⿰立青
鸇	true	鸇
乛	false	乛
隩	false	⿰阝奥
烘	true	烘
燠	false	⿰火奥
䭆	false	⿱卧食
朓	true	朓
腯	false	⿰月盾
官	false	官
芦	false	⿱⿻十丨户
垔	true	垔
縁	false	⿰糹⿱彐𧰨
朮	true	朮
駔	true	駔
餻	false	⿰飠羔
聽	true	聽
皰	true	皰
凡	true	凡
笑	true	笑
䀈	false	⿱既皿
辱	false	辱
覽	false	覽
闔	true	闔
饑	false	⿰飠幾
緲	false	⿰糹眇
是	true	是
似	true	似
礜	true	礜
鍊	true	鍊
顛	false	顛
臬	false	⿱自木
寘	false	⿱宀真
𠮷	false	𠮷
㪌	false	⿰甬攴
委	true	委
嬐	true	嬐
繭	false	⿱艹⿻⿵冂丨𬗌
巳	true	巳
濤	true	濤
枕	true	枕
繪	true	繪
臣	true	臣
觵	false	⿰角黄
邑	true	邑
嶴	false	⿱奥山
舀	false	舀
漒	false	⿰氵强
䮅	false	⿰馬戉
沙	true	沙
麔	false	⿸鹿咎
遏	true	遏
谸	true	谸
閶	true	閶
易	true	易
踤	true	踤
偶	true	偶
縷	false	⿰糹婁
娶	true	娶
録	false	録
撫	true	撫
昋	false	⿱天日
骼	true	骼
壬	true	壬
忍	true	忍
垗	true	垗
函	true	函
驒	true	驒
㙂	false	⿰土兑
皮	true	皮
腩	false	⿰月南
㝵	true	㝵
冷	true	冷
盼	true	盼
䴽	false	⿰麥卑
甍	false	⿱⿳艹罒冖瓦
駟	true	駟
啓	false	⿱𢼄口
弛	true	弛
后	true	后
肯	false	⿱止月
紃	false	⿰糹川
奉	true	奉
僨	true	僨
貞	true	貞
搢	false	⿰扌晋
兔	true	兔
大	true	大
儶	false	⿰亻巂
枈	false	⿱比木
紷	false	⿰糹令
㐬	false	㐬
澩	true	澩
玎	true	玎
譽	true	譽
晬	true	晬
禹	true	禹
勥	false	⿱強力
膦	false	⿰月粦
洴	false	⿰氵并
侻	false	⿰亻兑
珙	true	珙
富	true	富
噈	true	噈
倒	true	倒
褰	true	褰
非	true	非
縟	false	⿰糹辱
禨	false	⿰礻幾
留	false	留
舌	true	舌
區	true	區
腛	false	⿰月屋
遺	false	遺
膖	false	⿰月逢
戶	true	戶
妓	true	妓
案	false	⿱安木
虍	true	虍
雇	false	⿸户隹
某	true	某
永	false	永
艿	true	艿
䐽	false	⿰月㒼
躍	true	躍
畟	false	⿳田八夂
戠	true	戠
儇	true	儇
了	true	了
猝	true	猝
亮	true	亮
鶠	true	鶠
脆	false	⿰月危
衋	false	⿳聿皕血
䰁	false	⿱髟录
中	true	中
䑇	false	⿰月質
䡸	false	⿰車⿱𦭝戉
信	true	信
貆	true	貆
鰋	true	鰋
鱝	false	⿰魚賁
麃	false	麃
悎	false	⿰忄告
礪	true	礪
靡	false	靡
务	false	务
饟	false	⿰飠襄
录	false	录
懆	true	懆
豲	true	豲
衯	true	衯
冈	false	冈
㔯	false	⿷匚⿱𠘧口
覇	false	⿱覀䩗
代	true	代
七	true	七
慘	true	慘
膩	false	⿰月貳
嶠	true	嶠
繒	true	繒
个	true	个
另	false	另
餔	false	⿰飠甫
獡	false	⿰犭⿱臼⿹勹灬
佼	true	佼
併	true	併
斤	true	斤
操	true	操
糖	true	糖
遂	true	遂
檠	true	檠
衝	true	衝
殺	false	⿰杀殳
腢	false	⿰月禺
䐏	false	⿰月春
讀	true	讀
祡	true	祡
奔	true	奔
聸	true	聸
睩	false	⿰目录
与	true	与
魚	true	魚
莠	true	莠
𠬪	true	𠬪
衤	false	衤
意	true	意
誂	true	誂
餴	false	⿰飠奔
勦	true	勦
碰	false	⿰石並
禕	false	⿰礻韋
甸	true	甸
伯	true	伯
阡	true	阡
惷	true	惷
楊	true	楊
反	true	反
䳔	false	⿱臼鳥
雀	true	雀
鯨	true	鯨
笧	false	⿱竹册
撮	true	撮
北	true	北
衷	true	衷
芥	true	芥
哲	true	哲
瑨	false	⿰王晋
欿	true	欿
淈	true	淈
鋯	false	⿰金告
榘	false	⿱矩木
穵	true	穵
嵃	false	⿰山彦
先	true	先
䐭	false	⿰月帶
憂	true	憂
㻍	false	⿰王吴
墓	true	墓
哾	false	⿰口兑
舄	false	⿱臼⿹勹灬
儒	true	儒
慊	true	慊
弗	false	弗
偵	true	偵
柆	true	柆
㧀	false	⿸户及
睂	false	⿱⿰仌丨⿸厂目
鮝	false	⿱龹魚
綪	false	⿰糹青
雥	false	雥
姨	true	姨
嘼	true	嘼
寸	true	寸
剷	false	⿰産刂
來	true	來
叚	true	叚
盝	false	⿱录皿
膂	false	⿱旅月
胎	false	⿰月台
華	true	華
任	true	任
呉	false	⿳⿺𠃑口一八
耎	false	耎
鍑	true	鍑
稟	true	稟
䐞	false	⿰月弱
倞	true	倞
燂	true	燂
倬	true	倬
埶	false	埶
鬯	true	鬯
剆	false	⿰⿱丶⑤刂
仄	true	仄
句	true	句
異	true	異
劦	true	劦
饖	false	⿰飠歲
䊲	false	⿰粟産
䋀	false	⿸户糸
薁	false	⿱⿻十丨奥
饅	false	⿰飠⿳日罒又
䭐	false	⿰飠恙
霍	false	霍
兄	true	兄
譃	false	⿰言虚
巻	false	⿱龹己
胱	false	⿰月光
吕	false	吕
兹	false	兹
湞	true	湞
廉	true	廉
棸	false	⿱取木
困	false	困
祒	false	⿰礻召
詹	true	詹
胜	false	⿰月生
洹	true	洹
禛	false	⿰礻真
痬	true	痬
偉	true	偉
係	true	係
湍	true	湍
冒	true	冒
䏿	false	⿱𢼄月
觼	false	⿰角⿳⿱𠂊𠔿目夂
覬	true	覬
蓋	true	蓋
天	true	天
貙	true	貙
攽	true	攽
䆞	true	䆞
荔	true	荔
腞	false	⿰月彖
夏	true	夏
紸	false	⿰糹主
涾	true	涾
稵	false	⿰禾兹
黲	true	黲
槍	true	槍
共	true	共
賊	true	賊
胙	true	胙
饐	false	⿰飠壹
馳	true	馳
羡	false	羡
臅	false	⿰月蜀
虡	false	⿸虚八
瓷	true	瓷
毁	false	毁
祁	false	⿰礻阝
棠	false	⿱𫩠木
僊	true	僊
鉥	false	⿰金术
閤	true	閤
皕	true	皕
郭	true	郭
槽	true	槽
禬	false	⿰礻會
饠	false	⿰飠羅
瀆	true	瀆
䭖	false	⿰飠庶
肎	false	⿱冖月
𤺄	true	𤺄
軨	true	軨
侃	true	侃
洸	true	洸
㶧	false	⿰火内
厥	false	厥
槧	false	⿱斬木
䝈	false	⿰豕卮
鎫	false	⿰金⿳⿱丿冈八夂
湁	true	湁
巠	false	巠
尥	true	尥
鱨	true	鱨
耹	true	耹
摬	true	摬
營	false	⿱𤇾呂
興	true	興
臽	true	臽
日	true	日
俻	true	俻
巾	true	巾
艾	false	艾
綉	false	⿰糹秀
無	true	無
樔	true	樔
業	true	業
㦾	false	⿸户也
殰	true	殰
速	true	速
䴿	false	⿰麥冡
絘	true	絘
替	true	替
餂	false	⿰飠舌
伋	true	伋
廿	true	廿
勍	true	勍
烏	true	烏
札	true	札
淬	true	淬
鰥	false	⿰魚⿱罒⑤
膥	false	⿱⿰末成肉
綯	false	⿰糹匋
鬱	true	鬱
㪎	false	⿰夾攴
且	true	且
熅	false	⿰火𥁕
舮	false	⿰舟户
脛	false	⿰月巠
尨	false	⿷尤彡
妛	false	⿱㞢女
碌	false	⿰石录
臥	true	臥
泗	true	泗
階	true	階
㐌	false	㐌
餢	false	⿰飠咅
阱	true	阱
煜	true	煜
譟	true	譟
餾	false	⿰飠留
祲	false	⿰礻𠬶
縬	false	⿰糹戚
瑥	false	⿰王昷
蟜	true	蟜
㩓	false	⿱毀手
達	false	達
䙴	false	⿱䙲㔾
俾	true	俾
益	false	⿱⿱䒑八皿
西	true	西
縓	true	縓
虫	true	虫
乞	false	乞
咠	false	咠
岡	false	岡
坰	true	坰
弢	true	弢
㴄	false	⿰氵囧
朾	true	朾
徂	true	徂
翛	false	⿰⿰亻丨⿱夂羽
字	true	字
螆	false	⿰虫兹
紦	false	⿰糹巴
未	false	未
臑	false	⿰月需
𠃑	false	𠃑
𡿺	false	𡿺
䌝	false	⿰糹禁
息	false	息
咼	true	咼
腕	false	⿰月宛
饔	true	饔
麴	false	⿰麥匊
奴	true	奴
韗	true	韗
雐	false	雐
俞	true	俞
譭	false	⿰言毁
嬛	true	嬛
羋	true	羋
粐	false	⿰米户
踵	true	踵
赳	true	赳
鉏	true	鉏
続	false	⿰糹売
鬒	false	⿱髟真
俅	true	俅
趫	true	趫
汾	true	汾
綻	false	⿰糹定
腰	false	⿰月要
紐	false	⿰糹丑
簧	false	⿱竹黄
潞	true	潞
㢏	false	⿸广俞
元	true	元
咢	true	咢
㐅	false	㐅
獒	true	獒
承	true	承
繓	false	⿰糹最
㨰	false	⿰扌衮
䖔	true	䖔
億	true	億
母	true	母
婟	true	婟
愈	false	⿱俞心
梏	false	⿰木告
驂	true	驂
萮	false	⿱⿻十丨俞
光	true	光
丰	true	丰
斬	false	斬
牘	true	牘
園	true	園
卤	true	卤
溥	false	溥
口	true	口
邱	true	邱
汳	true	汳
胐	false	⿰月出
墳	true	墳
䏽	false	⿰月咅
磑	true	磑
纑	false	⿰糹盧
䌵	false	⿰糹屬
祴	false	⿰礻戒
聚	true	聚
客	true	客
鰜	true	鰜
老	true	老
婦	true	婦
出	true	出
靕	false	⿰正青
險	true	險
牏	false	⿰片俞
層	true	層
馮	true	馮
攸	true	攸
厜	true	厜
捽	true	捽
剴	true	剴
亘	true	亘
燊	false	⿱焱木
腲	false	⿰月畏
互	true	互
俺	true	俺
慕	true	慕
橘	true	橘
禈	false	⿰礻軍
幷	false	幷
連	false	連
緎	false	⿰糹或
䏙	false	⿰月冘
䡴	true	䡴
䑊	false	⿰月遺
鱋	false	⿰魚虚
絟	false	⿰糹全
緖	false	⿰糹者
𤾡	false	𤾡
拹	true	拹
釉	false	⿰釆由
崔	false	崔
終	true	終
綵	false	⿰糹采
橥	false	⿱猪木
荑	true	荑
㚇	true	㚇
精	false	⿰米青
盾	true	盾
乂	true	乂
涸	true	涸
散	false	散
廣	true	廣
挑	true	挑
靛	false	⿰青定
埱	true	埱
䛇	false	⿰言⿱𠘧口
雧	false	⿱雥木
䵃	false	⿰麥黄
伔	false	⿰亻冗
伍	true	伍
狙	true	狙
廛	false	廛
䐔	false	⿰月⿸户𠕁
隙	false	⿰阝𡭴
祆	false	⿰礻天
糹	false	糹
童	true	童
凜	true	凜
禥	false	⿰礻基
劄	false	⿰答刂
明	true	明
後	true	後
禲	false	⿰礻厲
雩	true	雩
噌	false	⿰口曾
膻	true	膻
㠊	false	⿰山虛
縀	false	⿰糹叚
扌	false	扌
年	true	年
蠱	true	蠱
贏	true	贏
簬	true	簬
宐	false	⿱宀彑
蚈	false	⿰虫开
齤	false	⿱龹齒
潸	false	⿰氵⿱林月
飪	false	⿰飠壬
杸	true	杸
祘	false	⿰示示
祢	false	⿰礻尔
靪	true	靪
嫓	false	⿰女⿱⿱𠂊𠔿比
蠉	true	蠉
紜	false	⿰糹云
竫	false	⿰立争
小	true	小
𡲴	true	𡲴
槼	false	⿱規木
撧	false	⿰扌絕
倪	true	倪
鶤	true	鶤
飤	false	⿰飠人
雨	true	雨
穜	true	穜
刷	true	刷
絧	false	⿰糹同
褐	true	褐
再	true	再
宀	true	宀
䪏	false	⿰韋内
𠬛	true	𠬛
黱	false	⿰月⿱龹黑
餼	false	⿰飠氣
儃	true	儃
丹	true	丹
嗷	true	嗷
刼	false	⿰去刃
吟	true	吟
䬈	false	⿺風兑
餤	false	⿰飠炎
鐍	true	鐍
為	true	為
屈	true	屈
㦿	false	⿸户木
𡨄	false	𡨄
龔	true	龔
孑	true	孑
嶼	true	嶼
䐴	false	⿱既月
䜁	false	⿰言奊
乃	true	乃
乘	true	乘
名	true	名
护	false	⿰扌户
佚	true	佚
闐	false	⿵門真
厶	true	厶
腅	false	⿰月炎
艹	false	⿻十丨
胳	true	胳
樕	true	樕
零	true	零
旟	true	旟
趯	true	趯
庐	false	⿸广户
䏶	false	⿰月坒
呈	false	⿱口王
𡱒	true	𡱒
䐑	false	⿰月⿱世木
残	false	⿰歹戋
开	false	开
兒	true	兒
眥	true	眥
鼎	true	鼎
昄	true	昄
往	true	往
偽	true	偽
腍	false	⿰月念
坴	true	坴
仁	true	仁
鉗	true	鉗
趒	true	趒
埸	true	埸
脡	false	⿰月⿺廴壬
希	false	希
莂	false	⿱⿻十丨别
㺑	true	㺑
肬	false	⿰月尤
襌	true	襌
戉	true	戉
魶	false	⿰魚内
欠	true	欠
紡	false	⿰糹方
㾁	false	⿸疒术
傲	true	傲
掰	false	⿲龵分手
譎	true	譎
巹	false	⿱丞己
些	true	些
勻	true	勻
汽	true	汽
啗	true	啗
鼩	true	鼩
径	false	⿰彳𢀖
姚	true	姚
荓	false	⿱⿻十丨并
芳	false	芳
謜	true	謜
阹	true	阹
優	true	優
縝	false	⿰糹真
脬	false	⿰月孚
㤺	false	⿰忄巟
䈯	false	⿱竹真
蚡	true	蚡
丬	false	丬
鼇	true	鼇
鉤	true	鉤
勱	true	勱
蝨	true	蝨
歜	true	歜
環	true	環
格	true	格
訥	false	⿰言内
甫	false	甫
昏	false	昏
雋	false	雋
蝉	false	⿰虫单
韛	false	⿰韋𤰇
槊	false	⿱朔木
𥝢	false	𥝢
肹	false	⿰月兮
滲	true	滲
㒎	false	⿰亻䨿
績	false	⿰糹責
癤	false	⿸疒⿱竹即
羞	true	羞
㪱	false	⿰文奂
枮	true	枮
泔	true	泔
曺	false	⿱𤰔日
𠑽	false	𠑽
鉣	true	鉣
侜	true	侜
亳	true	亳
腉	false	⿰月兒
祫	true	祫
綘	false	⿰糹夆
引	true	引
坫	true	坫
緙	false	⿰糹革
庰	false	⿸广并
蚖	true	蚖
鼸	true	鼸
靈	true	靈
柒	false	⿱⿰氵七木
腏	false	⿰月叕
靲	true	靲
膄	false	⿰月⿱⿻臼丨又
黺	true	黺
俔	true	俔
顇	true	顇
暇	true	暇
匠	true	匠
仝	true	仝
龰	false	龰
備	true	備
厭	true	厭
𢛳	false	𢛳
羊	true	羊
貧	true	貧
楱	false	⿰木奏
譣	true	譣
渣	false	⿰氵查
州	true	州
絡	true	絡
勽	true	勽
䵍	false	⿰黄享
椯	true	椯
廩	true	廩
芰	true	芰
糝	true	糝
蟆	true	蟆
拑	true	拑
樿	true	樿
縩	false	⿰糹祭
或	true	或
酪	true	酪
餽	false	⿰飠鬼
猲	true	猲
冂	true	冂
肛	false	⿰月工
䵏	false	⿰黄翏
沛	false	⿰氵巿
艽	true	艽
𠬶	false	𠬶
伉	true	伉
䐼	false	⿰月絜
鳧	true	鳧
縮	false	⿰糹宿
䩮	false	⿰革录
宕	true	宕
柶	true	柶
杀	false	杀
仌	true	仌
愴	true	愴
禗	false	⿰礻思
璋	true	璋
債	true	債
絨	false	⿰糹戎
禸	true	禸
俴	true	俴
輕	true	輕
尻	true	尻
鐲	true	鐲
䌤	false	⿰糹爾
鬼	true	鬼
漢	true	漢
洪	true	洪
忮	true	忮
䴺	false	⿰麥咅
䦱	false	⿵門爲
葋	false	⿱⿻十丨朐
眺	true	眺
臔	false	⿰月賢
充	true	充
籾	false	⿰米刃
冘	true	冘
惡	true	惡
義	true	義
蹭	true	蹭
㴳	false	⿲氵土⿷尤彡
歲	true	歲
祅	false	⿰礻夭
真	true	真
父	true	父
䩶	false	⿰革蚩
驙	true	驙
急	true	急
侖	true	侖
饈	false	⿰飠羞
俄	true	俄
㓞	true	㓞
翎	true	翎
禋	false	⿰礻垔
趪	false	⿺走黃
餖	false	⿰飠豆
汃	true	汃
遝	false	⿺辶⿱罒⑤
汮	false	⿰氵匀
鋁	false	⿰金吕
卂	true	卂
䧹	false	䧹
悆	true	悆
𦔻	false	𦔻
泠	true	泠
㺿	false	⿰王𦣞
足	true	足
澺	true	澺
谷	true	谷
頙	false	⿰正頁
䍵	false	⿰羊争
佶	true	佶
專	false	專
盟	true	盟
䈧	false	⿱竹為
胥	false	⿱疋月
②	false	②
髤	false	⿱髟木
卷	false	⿱龹㔾
巴	true	巴
旳	true	旳
芩	true	芩
艅	true	艅
絃	false	⿰糹玄
鯕	true	鯕
䌆	false	⿰糹鬼
嘽	true	嘽
纏	false	⿰糹廛
嫵	true	嫵
黤	true	黤
彡	true	彡
疋	true	疋
飾	false	⿰飠⿱𠂉巾
籸	false	⿰米卂
看	true	看
𫩠	false	𫩠
紹	false	⿰糹召
細	true	細
必	true	必
龣	false	⿰龠录
䲤	false	⿰鱼酒
凊	false	⿰冫青
丽	false	⿱一⿰⿵冂丶⿵冂丶
雖	true	雖
裞	false	⿰衤兑
槩	false	⿱既木
芀	true	芀
麭	false	⿰麥包
摡	false	⿰扌既
所	false	⿰戶斤
眔	false	⿱罒⑤
饎	false	⿰飠喜
膎	false	⿰月奚
鋿	false	⿰金尚
稂	true	稂
府	true	府
嬨	false	⿰女慈
韐	true	韐
范	true	范
殟	false	⿰歹𥁕
𪎥	true	𪎥
懡	false	⿰忄麽
灰	true	灰
㕡	true	㕡
犭	false	犭
皚	true	皚
阞	true	阞
䐓	false	⿰月頁
丁	true	丁
暴	true	暴
昌	true	昌
怍	true	怍
餦	false	⿰飠長
溍	false	⿰氵晋
莌	false	⿱⿻十丨兑
狊	false	狊
匿	true	匿
失	true	失
佽	true	佽
才	true	才
兵	true	兵
莨	true	莨
脊	true	脊
緱	false	⿰糹侯
㒨	false	⿰亻⿱𦦉巳
餶	false	⿰飠骨
榔	false	⿰木郎
卻	true	卻
肘	false	⿰月寸
綁	false	⿰糹邦
服	true	服
喝	true	喝
禼	true	禼
牖	false	⿰片⿸户甫
綶	false	⿰糹果
絵	false	⿰糹会
鎾	false	⿰金昷
鶿	false	⿱兹鳥
糨	false	⿰米强
耷	false	耷
喿	true	喿
摒	false	⿰扌屏
紎	false	⿰糹犬
匸	true	匸
自	true	自
綍	false	⿰糹孛
頫	true	頫
畏	true	畏
濯	true	濯
請	false	⿰言青
纋	false	⿰糹憂
釣	true	釣
鱮	true	鱮
㳇	false	⿰氵父
煁	true	煁
溘	true	溘
增	true	增
締	false	⿰糹帝
隒	true	隒
䜇	false	⿰言衮
䯚	false	⿰骨⿱幺月
穡	true	穡
氛	true	氛
鞭	true	鞭
腶	false	⿰月段
沚	true	沚
膆	false	⿰月素
鄒	true	鄒
初	true	初
暍	true	暍
宫	false	宫
𠂊	false	𠂊
牛	true	牛
膾	false	⿰月會
倅	true	倅
旬	true	旬
訾	true	訾
扊	false	⿸户炎
帍	false	⿸户巾
䏦	false	⿰月舌
沪	false	⿰氵户
赹	false	⿺走匀
用	true	用
相	false	相
儉	true	儉
窬	false	⿱穴俞
赧	false	⿰赤𠬝
䏒	false	⿰月片
打	true	打
聱	true	聱
話	true	話
骨	true	骨
包	true	包
餜	false	⿰飠果
䏔	false	⿰月丑
尸	true	尸
葛	true	葛
疐	false	疐
内	true	内
叔	true	叔
膅	false	⿰月⿸广⿱肀口
銚	true	銚
要	true	要
祐	false	⿰礻右
埓	false	⿰土⿱④寸
郤	true	郤
膽	true	膽
奲	true	奲
旉	false	旉
几	true	几
臺	true	臺
苗	true	苗
覊	false	⿱覀䩻
嬔	false	⿰女⿺兔生
従	false	従
複	true	複
臖	false	⿱興月
𦘒	false	𦘒
否	false	否
緶	true	緶
鹽	true	鹽
茾	false	茾
軓	true	軓
騊	true	騊
麯	false	⿰麥曲
麑	false	⿸鹿兒
眅	true	眅
催	true	催
馰	true	馰
鼓	true	鼓
𣅽	false	𣅽
黰	false	⿰黑真
兏	false	⿸厂𠑷
其	true	其
藚	true	藚
戋	false	戋
梀	true	梀
獧	true	獧
侔	true	侔
鎯	false	⿰金郎
禠	false	⿰礻虒
赤	true	赤
弱	true	弱
处	false	⿺夂卜
觜	true	觜
腓	false	⿰月非
䐿	false	⿰月奥
㮂	false	⿱具木
蒿	true	蒿
匈	true	匈
豉	true	豉
素	true	素
婼	true	婼
昜	true	昜
腌	false	⿰月奄
蛸	true	蛸
隃	false	⿰阝俞
敆	true	敆
伏	true	伏
亞	true	亞
蛀	false	⿰虫主
腒	false	⿰月居
膫	false	⿰月尞
創	true	創
墇	true	墇
楌	false	⿰木彦
侁	true	侁
霡	false	⿱雨⿰月永
聆	true	聆
肀	false	肀
怙	true	怙
胓	false	⿰月平
榼	true	榼
淑	true	淑
䌳	false	⿰糹璽
斪	true	斪
午	true	午
鮥	true	鮥
人	true	人
腭	false	⿰月咢
襔	false	⿰衤㒼
麸	false	⿰麦夫
喌	true	喌
堇	false	堇
鼭	false	⿰鼠寺
喪	true	喪
絳	false	⿰糹夅
難	false	⿰⿱廿⿻口夫隹
繆	false	⿰糹翏
朴	true	朴
廎	true	廎
鼐	true	鼐
鴝	true	鴝
價	true	價
柴	true	柴
害	false	⿱𫲸口
矎	false	⿰目⿳⿱𠂊𠔿目夂
觡	true	觡
倉	true	倉
禃	false	⿰礻直
厓	true	厓
悔	false	⿰忄每
洮	true	洮
期	true	期
鼪	false	⿰鼠生
賾	false	⿰𦣞責
羌	false	⿸羊乚
走	true	走
騄	false	⿰馬录
趑	true	趑
儗	true	儗
巸	false	⿰𦣞巳
奐	false	⿳𠂊⿵冂八大
离	true	离
鶱	true	鶱
氯	false	⿹气录
仞	true	仞
娸	true	娸
芈	false	芈
腑	false	⿰月府
僚	true	僚
𣦟	true	𣦟
紭	false	⿰糹弘
邊	true	邊
黽	true	黽
孛	true	孛
僕	true	僕
絆	false	⿰糹⿱丷⿻二丨
阬	true	阬
貨	true	貨
䐶	false	⿰月朁
于	true	于
蟥	false	⿰虫黄
椞	false	⿱析木
值	true	值
宰	false	宰
胉	false	⿰月白
嶲	false	⿱山雋
会	false	会
屬	false	屬
扅	false	⿸户多
佴	true	佴
榮	false	⿱𤇾木
鵒	true	鵒
埩	false	⿰土争
縨	false	⿰糹晃
假	true	假
愛	true	愛
緭	false	⿰糹胃
芒	true	芒
兑	false	兑
肪	false	⿰月方
匹	true	匹
䱢	false	⿰魚争
龶	false	龶
瑱	false	⿰王真
韣	true	韣
梁	true	梁
諶	true	諶
綒	false	⿰糹孚
紞	true	紞
威	true	威
蝓	false	⿰虫俞
荷	true	荷
髑	true	髑
禱	false	⿰礻壽
昂	true	昂
趄	true	趄
賛	false	賛
豬	true	豬
蕫	true	蕫
焚	true	焚
鄕	false	⿲乡皀阝
膸	false	⿰月遀
擪	false	⿸厭手
奄	false	奄
䌜	false	⿰糹業
綑	false	⿰糹困
蠗	true	蠗
趼	false	⿰𧾷开
淶	true	淶
䳭	false	⿰即鳥
斗	true	斗
模	true	模
可	true	可
輸	false	⿰車俞
鱓	true	鱓
冕	false	⿱冃⿱𠂊⑤
𤍾	false	𤍾
姉	true	姉
榍	true	榍
猹	false	⿰犭查
夭	true	夭
膰	false	⿰月番
檓	false	⿰木毁
杝	true	杝
蛅	true	蛅
棈	false	⿰木青
言	true	言
䬯	true	䬯
鳸	false	⿸户鳥
遠	true	遠
迩	false	⿺辶尔
蝇	false	⿰虫黾
歊	true	歊
盷	false	⿰目匀
鉆	true	鉆
練	true	練
匡	true	匡
𤇾	false	𤇾
悊	true	悊
囷	false	囷
禶	false	⿰礻贊
傍	true	傍
𡨥	false	𡨥
枀	false	⿱公木
礴	false	⿰石⿱⿻十丨溥
胡	true	胡
毳	false	毳
䚛	false	⿰角告
多	true	多
肓	true	肓
㡀	false	⿻丷⿻巾八
䖙	false	⿱卧虒
蠢	true	蠢
頁	true	頁
冬	true	冬
凵	true	凵
滄	true	滄
景	true	景
盅	true	盅
𭾱	false	𭾱
脩	false	⿰⿰亻丨𡕙
繂	false	⿰糹率
饉	false	⿰飠堇
觥	true	觥
珝	true	珝
爢	false	⿸靡灬
絉	false	⿰糹术
紒	false	⿰糹介
䏲	false	⿰月弟
稘	true	稘
腂	false	⿰月果
將	false	將
襾	true	襾
腫	true	腫
糸	true	糸
昒	true	昒
獢	true	獢
京	true	京
巜	true	巜
倨	true	倨
醰	true	醰
腬	false	⿰月⿱矛木
醁	false	⿰酉录
郁	true	郁
聼	false	⿰⿱乛耳𢛳
宣	true	宣
僙	false	⿰亻黄
阼	true	阼
加	true	加
鼺	false	⿰鼠畾
隡	false	⿰阝産
偁	true	偁
佾	true	佾
苫	true	苫
倜	true	倜
熿	false	⿰火黄
逆	false	逆
带	false	带
豖	false	豖
胸	true	胸
烎	false	⿱开火
氺	false	氺
阯	true	阯
屋	true	屋
黂	true	黂
摾	false	⿰扌强
痥	false	⿸疒兑
坵	true	坵
焦	false	焦
貴	false	貴
広	false	広
綺	false	⿰糹奇
絿	false	⿰糹求
檨	false	⿰木羡
諳	true	諳
鳥	true	鳥
䏗	false	⿰月气
㧁	true	㧁
覈	false	⿱覀敫
鹼	true	鹼
騷	true	騷
郃	true	郃
及	true	及
舛	true	舛
圓	true	圓
産	false	産
絙	false	⿰糹亘
皐	false	⿱白𠦂
布	true	布
徙	true	徙
鵦	false	⿰鳥录
蚑	true	蚑
畜	true	畜
榦	false	⿰𠦝⿱人木
椂	false	⿰木录
藺	true	藺
欲	true	欲
卵	true	卵
雛	true	雛
惄	true	惄
彄	true	彄
胦	false	⿰月央
䬽	false	⿰飠兑
漕	true	漕
墴	false	⿰土黄
杓	true	杓
熒	true	熒
視	true	視
槖	false	⿱𥑟木
灺	true	灺
齺	true	齺
粵	true	粵
萃	true	萃
驅	true	驅
蠞	false	⿱⿱竹即虫
殳	true	殳
㘖	false	⿰口顔
諺	false	⿰言彦
扐	true	扐
夫	true	夫
剥	false	剥
肗	false	⿰月女
狅	false	⿰犭壬
齻	false	⿰齒真
磺	false	⿰石黄
篙	true	篙
纀	false	⿰糹僕
糶	true	糶
拐	false	⿰扌另
房	false	⿸户方
凑	false	⿰冫奏
惨	false	⿰忄参
堀	true	堀
俠	true	俠
朦	true	朦
南	true	南
黆	false	⿰黄冘
疕	true	疕
赬	true	赬
唳	false	⿰口⿸户犬
傾	true	傾
邙	true	邙
偏	true	偏
邦	false	邦
潛	true	潛
㹌	false	⿰牛産
孕	true	孕
讂	false	⿰言⿳⿱𠂊𠔿目夂
拜	true	拜
龠	true	龠
垣	true	垣
書	true	書
琡	true	琡
膙	false	⿰月强
㦢	false	⿰忄⿱竹即
凭	true	凭
戌	true	戌
納	false	⿰糹内
劣	true	劣
頻	false	⿰步頁
鬟	true	鬟
鵖	false	⿰⑤鳥
命	true	命
衾	true	衾
揭	true	揭
壳	false	⿱士冗
咞	false	⿰口开
憧	true	憧
蝘	true	蝘
爰	true	爰
居	true	居
謙	true	謙
紓	false	⿰糹予
膍	false	⿰月𣬉
懕	false	⿸厭心
紽	false	⿰糹它
磕	true	磕
隋	false	隋
織	true	織
䫄	false	⿰兑頁
告	false	告
作	true	作
膭	false	⿰月貴
饒	false	⿰飠堯
逢	false	逢
菉	false	⿱⿻十丨录
粉	true	粉
僧	true	僧
嘅	false	⿰口既
怯	true	怯
鸚	true	鸚
躳	false	⿰身吕
膯	false	⿰月登
𦕒	true	𦕒
畐	true	畐
扉	false	⿸户非
份	true	份
䬇	false	⿰兑風
䵐	false	⿰黄單
胠	true	胠
醧	true	醧
韭	true	韭
虒	false	虒
僔	true	僔
謄	false	⿰月誊
师	false	⿰⿰丨丿帀
侮	true	侮
閣	true	閣
祼	false	⿰礻果
蓲	true	蓲
硯	true	硯
僯	true	僯
怩	true	怩
陳	true	陳
轖	true	轖
夋	false	⿳厶八夂
蟫	true	蟫
氣	true	氣
垷	true	垷
籙	false	⿱竹録
襄	true	襄
鈞	false	⿰金匀
予	true	予
孚	true	孚
黯	true	黯
炷	false	⿰火主
綎	false	⿰糹⿺廴壬
䐛	false	⿰月耷
腸	false	⿰月昜
歔	false	⿰虚欠
胚	false	⿰月丕
𡕙	false	𡕙
焠	true	焠
計	true	計
船	true	船
鼣	false	⿰鼠犬
橾	true	橾
枯	true	枯
氐	false	⿱氏丶
壽	true	壽
齔	true	齔
櫽	false	⿱隱木
滞	false	⿰氵带
刂	false	刂
芴	true	芴
麂	false	⿸鹿几
襡	true	襡
龐	true	龐
籯	true	籯
驈	true	驈
孰	true	孰
吏	true	吏
䴮	false	⿰麥山
種	true	種
夸	true	夸
肐	false	⿰月乞
我	true	我
嘏	true	嘏
堚	true	堚
撢	true	撢
袷	true	袷
僦	true	僦
駉	true	駉
槮	true	槮
洄	true	洄
會	true	會
弮	false	⿱龹弓
膊	false	⿰月尃
那	true	那
贛	true	贛
汭	false	⿰氵内
獸	true	獸
萁	true	萁
晋	false	晋
爽	true	爽
疑	true	疑
妻	true	妻
宵	true	宵
夜	true	夜
䋛	false	⿰糹米
苴	true	苴
歰	false	歰
糿	false	⿰糹刀
如	true	如
火	true	火
斆	true	斆
辰	true	辰
撞	true	撞
櫂	true	櫂
瓄	false	⿰王賣
螂	false	⿰虫郎
檿	false	⿸厭木
楎	true	楎
䴲	false	⿰麥末
恆	false	恆
覦	false	⿰俞見
蛄	true	蛄
楘	false	⿱敄木
汀	true	汀
脙	false	⿰月求
怵	false	⿰忄术
倝	true	倝
愷	true	愷
䜒	false	⿰言奥
堪	true	堪
沽	true	沽
桇	false	⿱如木
維	true	維
東	true	東
厄	true	厄
縭	false	⿰糹离
跲	true	跲
校	true	校
迅	true	迅
纃	false	⿰糹齊
扁	false	⿸户𠕁
匙	true	匙
逃	true	逃
馥	true	馥
𨙧	true	𨙧
𠧪	true	𠧪
撗	false	⿰扌黄
芟	true	芟
姐	true	姐
云	true	云
𠦂	false	𠦂
枦	false	⿰木户
偆	true	偆
佃	true	佃
繎	false	⿰糹然
麫	false	⿰麥丐
沒	true	沒
貐	false	⿰豸俞
主	true	主
肊	true	肊
䃔	false	⿰石宫
㯯	false	⿰木⿱夅貝
衮	false	衮
瀑	true	瀑
膪	false	⿰月啻
情	false	⿰忄青
綼	false	⿰糹卑
䐄	false	⿰月臽
罰	true	罰
千	true	千
竘	true	竘
玉	true	玉
䐐	false	⿰月秋
僃	false	⿰亻⿱⿻十丨⿹勹用
遐	true	遐
擊	true	擊
𢼄	false	𢼄
縞	true	縞
㬊	false	⿱日爰
償	true	償
緍	false	⿰糹昏
嗔	false	⿰口真
臆	true	臆
脭	false	⿰月⿱口王
饊	false	⿰飠散
纓	false	⿰糹嬰
膇	false	⿰月追
腽	false	⿰月昷
最	true	最
合	true	合
台	false	台
並	true	並
麨	false	⿰麥少
工	true	工
曹	true	曹
𠯳	false	𠯳
电	false	电
砉	false	⿱丰石
𣅈	false	𣅈
湘	true	湘
驗	true	驗
𢦏	true	𢦏
炯	true	炯
繟	false	⿰糹單
艵	false	⿰并色
扇	false	⿸户羽
雍	true	雍
摷	true	摷
峼	false	⿰山告
鉈	true	鉈
茎	false	⿱⿻十丨𢀖
邍	false	⿺辶⿱备录
䎩	false	⿰耒甾
璜	false	⿰王黄
渝	false	⿰氵俞
翕	true	翕
⺼	false	⺼
衣	true	衣
莈	false	⿱⿻十丨没
祇	false	⿰礻氏
膏	false	⿱高月
僮	true	僮
俢	false	⿰亻⿱夂彡
睚	true	睚
寕	false	⿱㝉⿳丿罒丁
纒	false	⿰糹㕓
枘	false	⿰木内
幩	true	幩
㪖	false	⿰录攴
藏	true	藏
④	false	④
裔	true	裔
脗	false	⿰月𠯳
𠦝	false	𠦝
薟	true	薟
朻	true	朻
冶	true	冶
彙	true	彙
縱	false	⿰糹從
尓	false	尓
饁	true	饁
胞	true	胞
緞	false	⿰糹段
蝦	true	蝦
脦	false	⿰月忒
坋	true	坋
隫	false	⿰阝賁
嵫	false	⿰山兹
肚	false	⿰月土
肞	false	⿰月义
䚄	false	⿰录見
蟡	false	⿰虫爲
鬧	false	⿵鬥市
脾	false	⿰月卑
拱	true	拱
㣇	true	㣇
痁	true	痁
尚	true	尚
詶	true	詶
颯	true	颯
薑	true	薑
㺔	false	⿰犭爲
䍄	true	䍄
鐓	true	鐓
篹	false	⿱𮅕㔾
謲	true	謲
㜼	false	⿰女疊
紉	true	紉
軍	true	軍
頽	false	頽
卆	false	卆
甆	false	⿱兹瓦
夒	true	夒
鴺	true	鴺
奏	true	奏
啇	false	啇
禝	false	⿰礻⿳田八夂
鉛	false	⿰金⿱𠘧口
羕	false	⿱𦍌永
冃	true	冃
直	true	直
攵	false	攵
禮	true	禮
鄑	false	⿰晋阝
䐉	false	⿰月甾
掠	true	掠
䛎	false	⿰言穴
闄	false	⿵門要
銕	true	銕
麻	true	麻
枹	true	枹
妟	true	妟
脨	false	⿰月束
宋	true	宋
䡹	false	⿰車疐
娕	true	娕
縜	false	⿰糹員
鋃	true	鋃
睛	false	⿰目青
軥	true	軥
俚	true	俚
雜	true	雜
旭	true	旭
鳩	true	鳩
豢	false	⿱龹豕
辶	false	辶
䐤	false	⿰月差
鈉	false	⿰金内
墠	true	墠
嬻	false	⿰女賣
逯	false	⿺辶录
臃	false	⿰月雍
儳	true	儳
㿗	false	⿸疒頽
縎	false	⿰糹骨
盆	true	盆
焅	false	⿰火告
䴬	false	⿰麥弋
掅	false	⿰扌青
昷	false	昷
挌	true	挌
飽	true	飽
袞	false	⿳亠㕣𧘇
儕	true	儕
鞈	true	鞈
㶇	false	⿰氵横
𠤼	true	𠤼
敢	false	⿰⿱乛耳攵
黨	true	黨
輹	true	輹
爯	true	爯
過	true	過
睴	true	睴
寰	true	寰
厝	true	厝
齍	false	⿱齊皿
䑈	false	⿰月樂
毒	false	⿱龶母
横	false	横
唱	true	唱
鬇	false	⿱髟争
綧	false	⿰糹享
醋	true	醋
亟	true	亟
佸	true	佸
虚	false	虚
緂	false	⿰糹炎
述	true	述
秋	true	秋
蜋	true	蜋
关	false	⿱丷天
膟	false	⿰月率
𦐇	false	𦐇
絸	false	⿰糹見
燬	false	⿰火毁
䴵	false	⿰麥并
蒁	false	⿱⿻十丨述
庶	false	庶
蘷	false	⿳⿻十丨⿳一⿲止白巳八夂
瞼	true	瞼
毋	true	毋
傮	true	傮
町	true	町
幾	false	幾
恉	true	恉
腀	false	⿰月侖
涯	true	涯
寽	true	寽
𠨲	true	𠨲
綟	false	⿰糹⿸户犬
饍	false	⿰飠善
珎	false	⿰王尔
鷬	false	⿰黄鳥
夔	true	夔
焒	false	⿰火吕
唾	true	唾
畺	false	畺
坒	false	坒
佝	true	佝
扣	true	扣
强	false	强
紱	false	⿰糹⿺友丶
詛	true	詛
䏨	false	⿰月𠂤
綦	true	綦
腝	false	⿰月耎
疰	false	⿸疒主
𦦉	false	𦦉
慼	false	⿱戚心
亴	false	⿳⿳亠口冖土九
搴	true	搴
粹	true	粹
柃	true	柃
剌	true	剌
綛	false	⿰糹忍
浩	false	⿰氵告
汛	true	汛
麀	true	麀
㪬	false	⿰翟攴
鷽	true	鷽
鐔	true	鐔
背	true	背
得	true	得
驕	true	驕
匽	true	匽
䌖	false	⿰糹⿱隹木
笍	false	⿱竹内
尞	true	尞
讕	true	讕
飳	false	⿰飠主
胋	false	⿰月占
営	false	⿳𭕄冖吕
訄	true	訄
司	false	司
育	true	育
朕	true	朕
勤	false	⿰堇力
罾	true	罾
絍	false	⿰糹任
餺	false	⿰飠尃
詡	true	詡
祖	true	祖
乖	true	乖
登	false	登
餯	false	⿰飠彖
昀	false	⿰日匀
鉻	true	鉻
牢	true	牢
夐	false	⿳⿱𠂊𠔿目夂
麱	false	⿰麥甫
𠃊	false	𠃊
斂	true	斂
錫	true	錫
矜	true	矜
㿳	false	⿰皮甾
眷	false	⿱龹目
唶	true	唶
貼	true	貼
歐	true	歐
斢	false	⿰黄斗
爪	true	爪
去	true	去
尊	true	尊
切	true	切
絪	false	⿰糹因
綐	false	⿰糹兑
瞿	false	瞿
戾	false	⿸户犬
駾	false	⿰馬兑
拳	false	⿱龹手
寒	true	寒
銅	true	銅
𤰇	false	𤰇
恙	false	恙
呆	false	⿱口木
跚	false	⿰𧾷册
幺	true	幺
雗	false	⿰𠦝⿱人隹
儡	true	儡
炮	true	炮
腷	false	⿰月畐
曳	true	曳
䖹	false	⿰虫⺸
隆	false	⿰阝㚅
䐟	false	⿰月冓
檅	false	⿰木歲
況	true	況
貒	true	貒
耒	true	耒
求	true	求
克	true	克
夓	false	⿳⿴𦥑𦣻八夂
䐾	false	⿰月睪
𩵏	true	𩵏
類	false	⿰类頁
囧	true	囧
韌	true	韌
梔	true	梔
低	true	低
禩	false	⿰礻異
繖	false	⿰糹散
收	true	收
朋	false	朋
㱎	false	⿰⿱⿱罒⑤魚欠
沉	false	⿰氵冗
餪	false	⿰飠耎
繵	false	⿰糹亶
耏	true	耏
偰	true	偰
㳗	false	⿰氵⿱叉土
釁	false	⿱⿶⿱𦥑冖同⿱酉分
紕	false	⿰糹比
珡	true	珡
澹	true	澹
拾	true	拾
牽	false	牽
追	false	追
逼	true	逼
鞘	true	鞘
崑	true	崑
逍	true	逍
秀	true	秀
伾	true	伾
爛	true	爛
峋	true	峋
侵	true	侵
笮	true	笮
敘	true	敘
雪	true	雪
膢	false	⿰月婁
傭	true	傭
全	true	全
貪	true	貪
䑄	false	⿰月鼻
覧	false	⿱⿰臣⿱𠂉丶見
㡭	false	㡭
迺	true	迺
泰	true	泰
餈	true	餈
瘟	false	⿸疒昷
㐻	false	⿰亻内
盛	true	盛
婧	false	⿰女青
䏳	false	⿰月折
仚	true	仚
酖	true	酖
茨	true	茨
貉	true	貉
緅	true	緅
林	true	林
堂	true	堂
腺	false	⿰月泉
梊	false	⿱折木
解	true	解
慔	true	慔
忡	true	忡
回	true	回
拲	true	拲
支	true	支
牆	true	牆
鍮	false	⿰金俞
緵	false	⿰糹㚇
憚	true	憚
鯈	false	⿰⿰亻丨⿱夂魚
䏟	false	⿰月必
女	true	女
膷	false	⿰月鄉
仲	true	仲
勺	true	勺
跂	true	跂
邶	true	邶
欒	true	欒
𦒻	true	𦒻
妵	false	⿰女主
䪲	false	⿰兀頁
䴴	false	⿰麥占
障	true	障
夙	true	夙
祻	false	⿰礻固
祤	false	⿰礻羽
螘	true	螘
蠃	true	蠃
綩	false	⿰糹宛
婁	false	婁
膘	false	⿰月票
䎼	false	⿰耳录
虧	false	⿰雐亏
匱	true	匱
贈	true	贈
諒	true	諒
𠂢	false	𠂢
執	false	執
餫	true	餫
垚	true	垚
賆	false	⿰貝并
枽	false	⿱卋木
車	true	車
翾	true	翾
牀	true	牀
弼	true	弼
儐	true	儐
潯	true	潯
蟹	true	蟹
博	false	⿰十尃
纉	false	⿰糹賛
匌	true	匌
乇	true	乇
銩	false	⿰金丢
飻	false	⿰飠㐱
朐	false	朐
觓	true	觓
壺	true	壺
片	true	片
肮	false	⿰月亢
庖	true	庖
便	true	便
民	true	民
逞	false	⿺辶⿱口王